ʾaʿadnā pos=V,mood=IND,gen=MASC,per=2,voice=ACT,num=SG,aspect=IPFV tuʿid
ʾabadin pos=N,def=DEF,case=NOM,num=SG al-ʾabad
ʿabadtum pos=V,mood=IND,tense=PRS,gen=FEM,per=3,voice=PASS,num=SG,aspect=IPFV tuʿbadu
ʾaʿbāʾin pos=N,def=DEF,case=NOM,num=SG al-ʿibʾ
ʾabatā pos=V,mood=IND,gen=MASC,per=3,voice=PASS,num=DU,aspect=IPFV yuʾbayā
ʾābāṭ pos=N,def=DEF,case=GEN,num=DU al-ʾibṭayni
ʾābāṭun pos=N,poss=PSSD,case=GEN,num=SG ʾibṭi
ʾabayta pos=V,mood=IMP,gen=FEM,per=2,voice=ACT,num=DU ībayā
ʾabāzīna pos=N,def=INDF,case=NOM,num=SG ʾabzanun
ʾabāžūrātun pos=N,def=DEF,case=NOM,num=SG al-ʾabāžūru
ʾabāžūrayni pos=N,def=DEF,case=ACC,num=DU al-ʾabāžūrayni
ʾabāžūrun pos=N,def=DEF,case=GEN,num=SG al-ʾabāžūri
ʿabbadā pos=V,mood=IND,tense=PST,gen=MASC,per=3,voice=PASS,num=DU,aspect=IPFV ʿubbidā
ʿabbāsayn pos=ADJ,def=DEF,case=NOM,gen=MASC,num=SG al-ʿabbāsu
ʿabbās pos=ADJ,def=INDF,case=NOM,gen=FEM,num=PL ʿabbāsāt
ʾabbidna pos=V,mood=SBJV,gen=FEM,per=2,voice=PASS,num=DU tuʾabbadā
ʿabbidū pos=V,mood=IND,tense=PRS,gen=FEM,per=2,voice=PASS,num=SG,aspect=IPFV tuʿabbadīna
ʿabbidū pos=V,mood=IND,tense=PRS,gen=FEM,per=3,voice=ACT,num=DU,aspect=IPFV tuʿabbidāni
ʾabdānin pos=N,poss=PSSD,case=NOM,num=SG badan
ʿabdāni pos=N,def=DEF,case=GEN,num=SG al-ʿabdi
ʾabdān pos=N,def=INDF,case=GEN,num=SG badanin
ʾabdaʾ pos=V,mood=IND,gen=FEM,per=2,voice=PASS,num=PL,aspect=IPFV tubdaʾna
ʾabdaʾu pos=V,mood=SBJV,gen=FEM,per=1,voice=PASS,num=PL nubdaʾa
ʾabdilā pos=V,mood=IND,tense=PRS,gen=MASC,per=2,voice=ACT,num=DU,aspect=IPFV tubdilāni
ʿabdu pos=N,def=INDF,case=ACC,num=SG ʿabdan
ʾabhamat pos=V,mood=IND,tense=PRS,gen=MASC,per=1,voice=PASS,num=PL,aspect=IPFV nubhamu
ʾabhimā pos=V,mood=SBJV,gen=FEM,per=3,voice=PASS,num=DU tubhamā
ʾabjada pos=N,def=INDF,case=NOM,num=SG ʾabjadun
ʾabjadiyya pos=ADJ,def=DEF,case=NOM,gen=MASC,num=DU al-ʾabjadiyyāni
ʾabjadiyyatāni pos=ADJ,def=DEF,case=GEN,gen=FEM,num=DU al-ʾabjadiyyatayni
ʾabjadiyyatan pos=ADJ,def=DEF,case=ACC,gen=FEM,num=PL al-ʾabjadiyyāti
ʾabjadiyyun pos=ADJ,def=INDF,case=NOM,gen=MASC,num=SG ʾabjadī
ʾabḵira pos=N,def=DEF,case=ACC,num=SG al-buḵāra
ʾabḵirat pos=N,def=INDF,case=NOM,num=SG buḵārun
ʾablaḡatā pos=V,mood=IND,gen=FEM,per=1,voice=PASS,num=PL,aspect=IPFV nublaḡ
ʾablaʿta pos=V,mood=IND,gen=FEM,per=3,voice=PASS,num=SG,aspect=IPFV tublaʿ
ʾabni pos=V,mood=IND,gen=MASC,per=3,voice=PASS,num=DU,aspect=IPFV yubnayā
ʾabqa pos=V,mood=IND,gen=FEM,per=2,voice=ACT,num=DU,aspect=IPFV tabqayā
ʾabqā pos=V,mood=SBJV,gen=MASC,per=3,voice=ACT,num=DU yabqayā
ʿabqariyyatayn pos=ADJ,def=INDF,case=GEN,gen=FEM,num=DU ʿabqariyyatayni
ʿabqariyyatun pos=ADJ,def=INDF,case=NOM,gen=FEM,num=PL ʿabqariyyāt
ʿabqariyyayni pos=ADJ,def=DEF,case=NOM,gen=MASC,num=DU al-ʿabqariyyayn
ʾabraqat pos=V,mood=SBJV,gen=FEM,per=3,voice=ACT,num=SG tubriqa
ʾabraqta pos=V,mood=IND,gen=FEM,per=2,voice=ACT,num=PL,aspect=IPFV tubriqna
ʾabriqī pos=V,mood=IND,tense=PST,gen=FEM,per=2,voice=ACT,num=DU,aspect=IPFV ʾabraqtumā
ʾabruka pos=V,mood=IND,tense=PST,gen=FEM,per=3,voice=ACT,num=SG,aspect=IPFV barakat
ʾabruka pos=V,mood=SBJV,gen=FEM,per=1,voice=ACT,num=PL nabruka
ʾabṣaratā pos=V,mood=IND,tense=PST,gen=MASC,per=3,voice=ACT,num=PL,aspect=IPFV ʾabṣarū
ʾabṣarti pos=V,mood=IND,tense=PST,gen=FEM,per=1,voice=PASS,num=PL,aspect=IPFV ʾubṣirnā
ʾabṣuq pos=V,mood=IND,gen=FEM,per=3,voice=ACT,num=SG,aspect=IPFV tabṣuq
ʾabsuṭa pos=V,mood=IND,tense=PRS,gen=FEM,per=3,voice=ACT,num=PL,aspect=IPFV yabsuṭna
ʾabsuṭu pos=V,mood=IMP,gen=FEM,per=2,voice=ACT,num=PL ubsuṭna
ʾabtaʿida pos=V,mood=IND,gen=FEM,per=3,voice=ACT,num=SG,aspect=IPFV tabtaʿid
ʾabūḥu pos=V,mood=SBJV,gen=FEM,per=3,voice=ACT,num=DU tabūḥā
ʾabzani pos=N,def=DEF,case=GEN,num=SG al-ʾabzani
ʾabzanu pos=N,poss=PSSD,case=ACC,num=SG ʾabzana
ʾaḏāʿā pos=V,mood=IND,gen=MASC,per=2,voice=ACT,num=DU,aspect=IPFV tuḏīʿā
ʾaʿdadtu pos=V,mood=IND,gen=MASC,per=2,voice=PASS,num=DU,aspect=IPFV tuʿaddā
ʾaḍāfa pos=V,mood=IND,gen=MASC,per=3,voice=ACT,num=DU,aspect=IPFV yuḍīfā
ʾaḍafti pos=V,mood=SBJV,gen=MASC,per=2,voice=ACT,num=DU tuḍīfā
ʿaḍalata pos=N,def=INDF,case=ACC,num=PL ʿaḍalātin
ʿaḍalata pos=N,def=INDF,case=NOM,num=DU ʿaḍalatāni
ʿadamā pos=N,def=DEF,case=NOM,num=SG al-ʿadamu
ʿadamin pos=N,def=DEF,case=GEN,num=PL al-ʾaʿdāmi
ʾaʿdāmin pos=N,def=INDF,case=GEN,num=DU ʿadamayni
ʾādamiyyatun pos=ADJ,def=DEF,case=ACC,gen=MASC,num=PL al-ʾādamiyyīna
ʾādamiyyin pos=ADJ,def=INDF,case=NOM,gen=MASC,num=PL ʾādamiyyūna
ʾaʿdam pos=V,mood=IND,tense=PST,gen=FEM,per=2,voice=PASS,num=SG,aspect=IPFV ʿudimti
ʾadarrū pos=V,voice=PASS mudarr
ʾadarta pos=V,mood=IND,tense=PRS,gen=MASC,per=3,voice=ACT,num=SG,aspect=IPFV yudīru
ʿadasa pos=N,def=INDF,case=GEN,num=DU ʿadasatayni
ʿadasatāni pos=N,def=INDF,case=NOM,num=SG ʿadasa
ʿadasātin pos=N,def=INDF,case=NOM,num=DU ʿadasatayn
ʿādat pos=V,mood=IND,tense=PST,gen=FEM,per=3,voice=PASS,num=SG,aspect=IPFV ʿīdat
ʾadbaratā pos=V,mood=SBJV,gen=FEM,per=1,voice=PASS,num=SG ʾudbara
ad-dabābīsi pos=N,def=INDF,case=GEN,num=DU dabbūsayni
aḏ-ḏabāʾiḥa pos=N,def=DEF,case=NOM,num=PL aḏ-ḏabāʾiḥu
aḏ-ḏabāʾiḥ pos=N,def=DEF,case=NOM,num=PL aḏ-ḏabāʾiḥu
aḍ-ḍabba pos=N,def=INDF,case=NOM,num=PL ḍibābun
ad-dābbatu pos=N,poss=PSSD,case=NOM,num=DU dābbatā
ad-dabbūsāni pos=N,poss=PSSD,case=NOM,num=SG dabbūs
ad-dabbūs pos=N,poss=PSSD,case=NOM,num=DU dabbūsay
ad-dabībatayn pos=ADJ,def=INDF,case=ACC,gen=FEM,num=SG dabībatan
ad-dabībati pos=ADJ,def=DEF,case=NOM,gen=FEM,num=SG ad-dabība
aḏ-ḏabīḥatāni pos=N,def=DEF,case=GEN,num=PL aḏ-ḏabāʾiḥi
aḏ-ḏabīḥata pos=N,def=DEF,case=NOM,num=DU aḏ-ḏabīḥatāni
aḏ-ḏabīḥata pos=N,poss=PSSD,case=NOM,num=DU ḏabīḥatā
aḍ-ḍābiṭayn pos=N,def=INDF,case=ACC,num=PL ḍubbāṭan
ʿaḏḏabtumā pos=V,mood=IND,tense=PRS,gen=MASC,per=2,voice=PASS,num=SG,aspect=IPFV tuʿaḏḏabu
ʾaḍdādi pos=N,def=DEF,case=NOM,num=SG aḍ-ḍidd
ʾaḍdād pos=N,poss=PSSD,case=NOM,num=SG ḍidd
aḍ-ḍafāʾiri pos=N,def=INDF,case=GEN,num=DU ḍafīratayni
aḍ-ḍafāʾir pos=N,def=INDF,case=GEN,num=DU ḍafīratayni
ad-daffāni pos=N,poss=PSSD,case=NOM,num=DU daffay
ad-dafīʾatayn pos=ADJ,def=INDF,case=GEN,gen=MASC,num=SG dafīʾin
ad-dafīʾatu pos=ADJ,def=DEF,case=ACC,gen=MASC,num=DU ad-dafīʾayni
ad-dāfiʾatu pos=ADJ,def=INDF,case=GEN,gen=MASC,num=SG dāfiʾin
ad-daftarayn pos=N,def=DEF,case=NOM,num=SG ad-daftaru
aḏ-ḏahabī pos=ADJ,def=DEF,case=NOM,gen=FEM,num=PL aḏ-ḏahabiyyāt
aḏ-ḏahabī pos=ADJ,def=DEF,case=NOM,gen=MASC,num=SG aḏ-ḏahabiyyu
aḏ-ḏahabiyyatayn pos=ADJ,def=DEF,case=ACC,gen=FEM,num=DU aḏ-ḏahabiyyatayni
aḏ-ḏahabiyyātu pos=ADJ,def=INDF,case=ACC,gen=FEM,num=DU ḏahabiyyatayni
ad-dahšatayni pos=N,def=DEF,case=NOM,num=PL ad-dahaš
aḍ-ḍaʿīfu pos=ADJ,def=INDF,case=GEN,gen=FEM,num=PL ḍaʿīfātin
ad-dāʾimata pos=ADJ,def=INDF,case=NOM,gen=FEM,num=PL dāʾimāt
ad-dakākīna pos=N,def=DEF,case=ACC,num=DU ad-dukkānayni
ad-dakākīna pos=N,def=DEF,case=ACC,num=SG ad-dukkāna
ad-dakākīn pos=N,poss=PSSD,case=GEN,num=DU dukkānay
aḏ-ḏakariyyatāni pos=ADJ,def=DEF,case=GEN,gen=MASC,num=PL aḏ-ḏakariyyīna
aḏ-ḏakariyyayn pos=ADJ,def=DEF,case=NOM,gen=MASC,num=PL aḏ-ḏakariyyīn
aḏ-ḏakariyyūna pos=ADJ,def=INDF,case=ACC,gen=MASC,num=SG ḏakariyyan
aḏ-ḏakariyyūna pos=ADJ,def=INDF,case=GEN,gen=FEM,num=DU ḏakariyyatayni
aḏ-ḏanabayn pos=N,def=DEF,case=ACC,num=DU aḏ-ḏanabayni
aḏ-ḏanabi pos=N,def=DEF,case=ACC,num=DU aḏ-ḏanabayni
aḏ-ḏanabu pos=N,poss=PSSD,case=NOM,num=DU ḏanabā
ad-danānīri pos=N,poss=PSSD,case=NOM,num=DU dīnāray
aḏ-ḏanbāni pos=N,def=INDF,case=ACC,num=PL ḏanūban
aḏ-ḏanb pos=N,def=INDF,case=NOM,num=DU ḏanbayn
aḏ-ḏanb pos=N,poss=PSSD,case=NOM,num=DU ḏanbā
ad-daqīqa pos=N,def=DEF,case=NOM,num=DU ad-daqīqatayn
ad-darāhimu pos=N,def=INDF,case=GEN,num=DU dirhamayni
ad-daraju pos=N,poss=PSSD,case=ACC,num=DU darajay
ad-darakiyyayn pos=N,poss=PSSD,case=NOM,num=PL darakiyyī
aḍ-ḍararati pos=ADJ,def=INDF,case=NOM,gen=FEM,num=PL ḍararāt
aḍ-ḍarbatayni pos=N,def=INDF,case=NOM,num=DU ḍarbatāni
aḍ-ḍarbatayn pos=N,poss=PSSD,case=ACC,num=DU ḍarbatay
ad-darrājatayn pos=N,poss=PSSD,case=ACC,num=PL darrājāti
aḏ-ḏarriyyatayni pos=ADJ,def=DEF,case=NOM,gen=MASC,num=SG aḏ-ḏarriyyu
aḏ-ḏarriyyatu pos=ADJ,def=DEF,case=ACC,gen=MASC,num=PL aḏ-ḏarriyyīna
aḏ-ḏarriyyātu pos=ADJ,def=DEF,case=NOM,gen=FEM,num=DU aḏ-ḏarriyyatāni
aḏ-ḏarriyyayni pos=ADJ,def=DEF,case=ACC,gen=FEM,num=SG aḏ-ḏarriyyata
aḏ-ḏarriyyayni pos=ADJ,def=DEF,case=NOM,gen=MASC,num=SG aḏ-ḏarriyyu
aḍ-ḍarūra pos=N,def=DEF,case=GEN,num=SG aḍ-ḍarūrati
aḍ-ḍarūratayn pos=N,poss=PSSD,case=GEN,num=DU ḍarūratay
aḍ-ḍarūrātu pos=N,def=DEF,case=GEN,num=PL aḍ-ḍarūrāti
ad-dasātīru pos=N,poss=PSSD,case=GEN,num=PL dasātīri
ad-dawāʾa pos=N,def=INDF,case=NOM,num=SG dawāʾ
ad-dawāʾayni pos=N,poss=PSSD,case=NOM,num=PL ʾadwiyat
ad-dawāʾiri pos=N,def=DEF,case=NOM,num=SG ad-dāʾira
ad-dawāʾ pos=N,poss=PSSD,case=NOM,num=SG dawāʾu
ad-dawāwīni pos=N,def=INDF,case=NOM,num=PL dawāwīnu
ad-dawāwīnu pos=N,def=INDF,case=GEN,num=DU dīwānayni
ad-dawliyyatāni pos=ADJ,def=DEF,case=ACC,gen=MASC,num=SG ad-dawliyya
ad-dawliyyatāni pos=ADJ,def=INDF,case=GEN,gen=FEM,num=SG dawliyyatin
ad-dawliyyati pos=ADJ,def=INDF,case=GEN,gen=FEM,num=SG dawliyyatin
aḏ-ḏawqayni pos=N,def=INDF,case=GEN,num=DU ḏawqayni
aḏ-ḏayla pos=N,def=INDF,case=GEN,num=DU ḏaylayni
aḏ-ḏaylu pos=N,def=INDF,case=NOM,num=DU ḏaylāni
ʾaddaynā pos=V,mood=SBJV,gen=FEM,per=3,voice=ACT,num=PL yuʾaddīna
ʾaddayti pos=V,mood=IMP,gen=FEM,per=2,voice=ACT,num=SG ʾaddī
ʾaddaytum pos=V,mood=IND,tense=PST,gen=FEM,per=1,voice=ACT,num=PL,aspect=IPFV ʾaddaynā
aḍ-ḍibāb pos=N,poss=PSSD,case=NOM,num=PL ḍibāb
aḍ-ḍibābu pos=N,def=DEF,case=ACC,num=PL aḍ-ḍibāba
ʿaḏḏibā pos=V,mood=SBJV,gen=FEM,per=3,voice=PASS,num=SG tuʿaḏḏaba
ad-diblōmāni pos=N,def=INDF,case=ACC,num=SG diblōman
ad-diblūmāsiyyāni pos=ADJ,def=INDF,case=NOM,gen=MASC,num=SG diblūmāsiyyun
ad-diblūmāsiyyatayni pos=ADJ,def=INDF,case=NOM,gen=MASC,num=DU diblūmāsiyyayn
ad-diblūmāsiyyati pos=ADJ,def=DEF,case=NOM,gen=MASC,num=PL ad-diblūmāsiyyūna
ad-diblūmāsiyyayni pos=ADJ,def=DEF,case=NOM,gen=MASC,num=PL ad-diblūmāsiyyūna
ad-diblūmāsiyyīna pos=ADJ,def=DEF,case=GEN,gen=FEM,num=SG ad-diblūmāsiyyati
ad-diblūmāt pos=N,def=DEF,case=NOM,num=DU ad-diblūmatayn
ʿaḏḏib pos=V,mood=SBJV,gen=MASC,per=3,voice=PASS,num=SG yuʿaḏḏaba
aḍ-ḍiddāni pos=N,poss=PSSD,case=NOM,num=SG ḍiddu
aḍ-ḍifdaʿāni pos=N,def=INDF,case=NOM,num=SG ḍifdaʿun
ad-dimāḡi pos=N,poss=PSSD,case=GEN,num=DU dimāḡay
ad-dīnār pos=N,def=INDF,case=ACC,num=SG dīnāran
ad-dīnār pos=N,poss=PSSD,case=GEN,num=DU dīnāray
ad-dīnāṣawrayn pos=N,poss=PSSD,case=NOM,num=DU dīnāṣawray
ad-dīnāṣawri pos=N,def=DEF,case=GEN,num=PL ad-dīnāṣawrāti
ʾaddī pos=V,mood=IND,tense=PST,gen=FEM,per=3,voice=PASS,num=DU,aspect=IPFV ʾuddiyatā
aḏ-ḏirāʿa pos=N,def=DEF,case=ACC,num=PL aḏ-ḏurʿāna
ad-dirhama pos=N,def=INDF,case=NOM,num=SG dirhamun
ad-dirhami pos=N,poss=PSSD,case=GEN,num=SG dirhami
aḍ-ḍirsāni pos=N,poss=PSSD,case=ACC,num=PL ḍurūsa
aḍ-ḍirsayni pos=N,poss=PSSD,case=NOM,num=DU ḍirsā
aḍ-ḍirsayn pos=N,poss=PSSD,case=ACC,num=DU ḍirsay
ad-dīwānayni pos=N,def=DEF,case=NOM,num=DU ad-dīwānayn
ad-duʿāʾi pos=N,poss=PSSD,case=ACC,num=SG duʿāʾa
aḏ-ḏuʾbāni pos=N,poss=PSSD,case=GEN,num=DU ḏiʾbay
ad-dufūfi pos=N,def=INDF,case=NOM,num=DU daffayn
ad-dukkānāni pos=N,poss=PSSD,case=NOM,num=DU dukkānay
aḏ-ḏurʿānu pos=N,poss=PSSD,case=NOM,num=PL ḏurʿān
ad-dustūriyyi pos=ADJ,def=DEF,case=NOM,gen=FEM,num=PL ad-dustūriyyāt
ad-duwala pos=N,def=DEF,case=NOM,num=PL ad-duwal
ʾadillāʾi pos=N,def=INDF,case=NOM,num=DU dalīlāni
ʿadimta pos=V,mood=IMP,gen=FEM,per=2,voice=ACT,num=DU iʿdamā
ʾadīrā pos=V,mood=IND,tense=PRS,gen=MASC,per=3,voice=PASS,num=SG,aspect=IPFV yudāru
ʾadīrū pos=V,mood=IND,tense=PRS,gen=MASC,per=3,voice=ACT,num=SG,aspect=IPFV yudīru
ʾaḏīʿū pos=V,mood=IND,tense=PRS,gen=FEM,per=3,voice=ACT,num=PL,aspect=IPFV yuḏiʿna
adʿiya pos=N,poss=PSSD,case=NOM,num=DU duʿāʾay
adʿiyat pos=N,def=INDF,case=GEN,num=DU duʿāʾayni
adʿiyat pos=N,def=INDF,case=NOM,num=SG duʿāʾun
ʿādiyyatin pos=ADJ,def=DEF,case=NOM,gen=FEM,num=PL al-ʿādiyyātu
ʾadḵalatā pos=V,mood=IMP,gen=FEM,per=2,voice=ACT,num=SG ʾadḵilī
ʾadḵalta pos=V,mood=IND,gen=FEM,per=3,voice=PASS,num=PL,aspect=IPFV yudḵalna
ʾaḏkartumā pos=V,mood=IND,tense=PRS,gen=MASC,per=3,voice=PASS,num=DU,aspect=IPFV yuḏkarāni
ʾaḏkirū pos=V,mood=IMP,gen=FEM,per=2,voice=ACT,num=DU ʾaḏkirā
ʾaḏnabti pos=V,mood=IND,tense=PST,gen=MASC,per=3,voice=ACT,num=PL,aspect=IPFV ʾaḏnabū
ʾaḏnabtumā pos=V,mood=IND,tense=PRS,gen=MASC,per=1,voice=ACT,num=PL,aspect=IPFV nuḏnibu
ʾaḏnabtunna pos=V,mood=SBJV,gen=FEM,per=2,voice=ACT,num=DU tuḏnibā
ʾadrājun pos=N,poss=PSSD,case=NOM,num=SG daraj
ʾadrarnā pos=V,mood=IND,tense=PST,gen=FEM,per=3,voice=PASS,num=PL,aspect=IPFV ʾudrirna
ʾadrartumā pos=V,mood=IMP,gen=FEM,per=2,voice=ACT,num=PL ʾadrirna
ʾadri pos=V,mood=IND,gen=MASC,per=3,voice=PASS,num=PL,aspect=IPFV yudraw
ʾadruju pos=V,mood=IND,tense=PRS,gen=FEM,per=3,voice=PASS,num=SG,aspect=IPFV tudraju
ʾaḍṭarra pos=V,mood=SBJV,gen=MASC,per=3,voice=ACT,num=PL yaḍṭarrū
ʾadʿū pos=V,mood=IND,tense=PST,gen=FEM,per=3,voice=ACT,num=SG,aspect=IPFV daʿat
ʾaḏūqu pos=V,mood=IND,gen=MASC,per=3,voice=ACT,num=DU,aspect=IPFV yaḏūqā
ʿaduwwin pos=N,def=DEF,case=GEN,num=PL al-ʾaʿdāʾi
ʿaduwwi pos=N,def=INDF,case=NOM,num=SG ʿaduww
ʾaḏwāqan pos=N,def=INDF,case=GEN,num=PL ʾaḏwāqin
ʾadwiyatan pos=N,poss=PSSD,case=NOM,num=PL ʾadwiyatu
ʾafadtum pos=V,mood=IND,tense=PST,gen=MASC,per=3,voice=PASS,num=SG,aspect=IPFV ʾufīda
ʿafajā pos=V,mood=IND,gen=FEM,per=2,voice=PASS,num=SG,aspect=IPFV tuʿfajī
ʾāfa pos=N,def=INDF,case=NOM,num=SG ʾāfatun
ʾāfāt pos=N,def=DEF,case=NOM,num=PL al-ʾāfāt
ʿafat pos=V,mood=IND,gen=MASC,per=2,voice=PASS,num=PL,aspect=IPFV tuʿfaw
ʾafḡāniyyan pos=ADJ,def=INDF,case=NOM,gen=FEM,num=DU ʾafḡāniyyatayn
ʾafḡāniyyīna pos=ADJ,def=INDF,case=ACC,gen=FEM,num=PL ʾafḡāniyyātin
ʾafḡāniyyīna pos=ADJ,def=INDF,case=NOM,gen=MASC,num=DU ʾafḡāniyyāni
ʾafḡāniyyin pos=ADJ,def=DEF,case=NOM,gen=MASC,num=SG al-ʾafḡānī
ʾafḥuš pos=V,mood=IND,tense=PRS,gen=MASC,per=3,voice=ACT,num=DU,aspect=IPFV yafḥušāni
ʾafʾidatun pos=N,def=DEF,case=ACC,num=PL al-ʾafʾidata
ʾafḵāḏi pos=N,def=DEF,case=GEN,num=SG al-faḵiḏi
ʾaflaḥū pos=V,mood=SBJV,gen=MASC,per=1,voice=ACT,num=PL nufliḥa
ʾaflāki pos=N,def=DEF,case=GEN,num=DU al-falakayni
ʾaflāmin pos=N,def=DEF,case=GEN,num=SG al-filmi
ʾaflāmin pos=N,poss=PSSD,case=GEN,num=SG filmi
ʾafnaytunna pos=V,mood=IND,gen=FEM,per=3,voice=PASS,num=SG,aspect=IPFV tufna
ʾafnū pos=V,mood=SBJV,gen=MASC,per=3,voice=ACT,num=PL yufnū
ʾafqara pos=V,mood=SBJV,gen=MASC,per=1,voice=ACT,num=SG ʾufqira
ʾafqisa pos=V,mood=IND,tense=PST,gen=FEM,per=1,voice=PASS,num=SG,aspect=IPFV fuqistu
ʾafrāsa pos=N,def=INDF,case=GEN,num=SG farasin
ʾafriju pos=V,mood=IND,gen=FEM,per=2,voice=PASS,num=PL,aspect=IPFV tufrajna
ʾafriša pos=N,def=DEF,case=NOM,num=PL al-ʾafrišatu
ʾafrišati pos=N,def=INDF,case=GEN,num=SG firāšin
ʾaftaʿil pos=V,mood=IND,tense=PRS,gen=FEM,per=1,voice=ACT,num=SG,aspect=IPFV ʾaftaʿilu
ʾaftaʿil pos=V,mood=IND,tense=PST,gen=FEM,per=1,voice=PASS,num=SG,aspect=IPFV uftuʿiltu
ʾafʾusan pos=N,def=INDF,case=NOM,num=DU faʾsāni
ʾaḡbarāni pos=ADJ,def=DEF,case=NOM,gen=MASC,num=PL al-ḡubr
ʾaḡbarayni pos=ADJ,def=DEF,case=NOM,gen=FEM,num=SG al-ḡabrāʾu
ʾaḡḍaba pos=V,mood=IND,tense=PRS,gen=MASC,per=3,voice=PASS,num=SG,aspect=IPFV yuḡḍabu
ʾaḡḍabu pos=V,mood=IND,tense=PRS,gen=FEM,per=2,voice=ACT,num=SG,aspect=IPFV taḡḍabīna
ʾaḡdiyatun pos=N,poss=PSSD,case=NOM,num=PL ʾaḡdiyat
ʾaḡību pos=V,mood=IND,gen=FEM,per=2,voice=ACT,num=PL,aspect=IPFV taḡibna
ʾaḡlaqnā pos=V,mood=SBJV,gen=MASC,per=2,voice=PASS,num=SG tuḡlaqa
ʾaḡlaqū pos=V,mood=IND,gen=MASC,per=2,voice=PASS,num=SG,aspect=IPFV tuḡlaq
ʾaḡlāṭin pos=ADJ,def=DEF,case=NOM,gen=MASC,num=SG al-ḡalaṭ
ʾaḡribati pos=N,poss=PSSD,case=GEN,num=DU ḡurābay
ʾaḡribatun pos=N,poss=PSSD,case=ACC,num=PL ʾaḡribata
ʾaḥakkat pos=V,mood=SBJV,gen=MASC,per=2,voice=ACT,num=SG tuḥikka
ʾaḥaltumā pos=V,mood=IND,tense=PRS,gen=FEM,per=3,voice=ACT,num=DU,aspect=IPFV tuḥīlāni
ʾaḥassa pos=V,mood=SBJV,gen=MASC,per=1,voice=PASS,num=SG ʾuḥassa
ʾaḥbabtum pos=V,mood=IND,tense=PST,gen=FEM,per=2,voice=ACT,num=DU,aspect=IPFV ʾaḥbabtumā
ʾaḥbaṭa pos=V,mood=IMP,gen=MASC,per=2,voice=ACT,num=DU ʾaḥbiṭā
ʾaḥbaṭa pos=V,mood=IND,tense=PST,gen=FEM,per=3,voice=ACT,num=PL,aspect=IPFV ʾaḥbaṭna
ʾaḥbaṭnā pos=V,mood=IND,gen=FEM,per=2,voice=PASS,num=DU,aspect=IPFV tuḥbaṭā
ʾaḥḍānan pos=N,def=INDF,case=NOM,num=DU ḥiḍnāni
ʿahdan pos=N,poss=PSSD,case=NOM,num=DU ʿahday
ʾaḥḍānu pos=N,def=INDF,case=GEN,num=SG ḥiḍnin
ʾaḥḍarā pos=V,mood=SBJV,gen=FEM,per=2,voice=ACT,num=DU tuḥḍirā
ʾaḥḍarat pos=V,mood=IND,tense=PST,gen=MASC,per=3,voice=PASS,num=SG,aspect=IPFV ʾuḥḍira
ʾaḥḍartumā pos=V,mood=IND,tense=PST,gen=FEM,per=1,voice=ACT,num=SG,aspect=IPFV ʾaḥḍartu
ʾaḥḍartum pos=V,mood=IND,tense=PRS,gen=FEM,per=3,voice=PASS,num=SG,aspect=IPFV tuḥḍaru
ʾaḥḍir pos=V,mood=SBJV,gen=MASC,per=3,voice=PASS,num=SG yuḥḍara
ʾaḥḏiyat pos=N,poss=PSSD,case=NOM,num=SG ḥiḏāʾu
ʾaḥḍun pos=V,mood=IND,gen=FEM,per=2,voice=PASS,num=PL,aspect=IPFV tuḥḍanna
ʾaḥduṯu pos=V,mood=IND,gen=FEM,per=3,voice=ACT,num=SG,aspect=IPFV taḥduṯ
ʾaḥfaẓat pos=V,mood=SBJV,gen=FEM,per=1,voice=PASS,num=PL nuḥfaẓa
ʾaḥfila pos=V,mood=IND,gen=FEM,per=1,voice=PASS,num=PL,aspect=IPFV nuḥfal
ʿahidatā pos=V,mood=IND,gen=MASC,per=1,voice=PASS,num=SG,aspect=IPFV ʾuʿhad
ʾaḥikkī pos=V,mood=IND,tense=PRS,gen=FEM,per=3,voice=PASS,num=PL,aspect=IPFV yuḥkakna
ʾahilla pos=N,def=DEF,case=NOM,num=DU al-hilālayn
ʾahillatan pos=N,def=DEF,case=NOM,num=SG al-hilālu
ʾaḥissū pos=V,mood=IND,gen=MASC,per=3,voice=ACT,num=DU,aspect=IPFV yuḥissā
ʾahjarna pos=V,mood=IMP,gen=MASC,per=2,voice=ACT,num=SG ʾahjir
ʾahjartum pos=V,mood=IMP,gen=MASC,per=2,voice=ACT,num=DU ʾahjirā
ʾahjartunna pos=V,mood=IND,tense=PRS,gen=MASC,per=2,voice=ACT,num=SG,aspect=IPFV tuhjiru
ʾaḥkū pos=V,mood=IND,tense=PST,gen=MASC,per=3,voice=ACT,num=DU,aspect=IPFV ḥakawā
ʾaḥmada pos=V,mood=IND,tense=PST,gen=MASC,per=3,voice=PASS,num=DU,aspect=IPFV ʾuḥmidā
ʾaḥmadtum pos=V,mood=IND,gen=MASC,per=2,voice=ACT,num=DU,aspect=IPFV tuḥmidā
ʾaḥmadtunna pos=V,mood=IND,tense=PRS,gen=FEM,per=1,voice=PASS,num=PL,aspect=IPFV nuḥmadu
ʾaḥmala pos=V,mood=IND,tense=PST,gen=MASC,per=1,voice=PASS,num=PL,aspect=IPFV ʾuḥmilnā
ʾaḥmalat pos=V,mood=IND,gen=FEM,per=2,voice=ACT,num=PL,aspect=IPFV tuḥmilna
ʾaḥmidā pos=V,mood=IND,tense=PRS,gen=MASC,per=2,voice=ACT,num=SG,aspect=IPFV tuḥmidu
ʾaḥmidna pos=V,mood=SBJV,gen=FEM,per=1,voice=ACT,num=PL nuḥmida
ʾaḥmī pos=V,mood=IND,gen=FEM,per=3,voice=PASS,num=PL,aspect=IPFV yuḥmayna
ʾaḥnākin pos=N,poss=PSSD,case=GEN,num=DU ḥanakay
ʾaḥnāk pos=N,def=INDF,case=NOM,num=PL ʾaḥnāk
ʾaḥqawqifa pos=V,mood=IND,tense=PRS,gen=FEM,per=2,voice=ACT,num=PL,aspect=IPFV taḥqawqifna
ʾahrāmin pos=N,def=DEF,case=GEN,num=PL al-ʾahrāmi
ʾaḥramna pos=V,mood=IMP,gen=MASC,per=2,voice=ACT,num=PL ʾaḥrimū
ʾaḥramnā pos=V,mood=IND,tense=PST,gen=MASC,per=2,voice=PASS,num=PL,aspect=IPFV ʾuḥrimtum
ʾaḥramtum pos=V,mood=IND,gen=FEM,per=3,voice=PASS,num=DU,aspect=IPFV tuḥramā
ʾaḥriq pos=V,mood=IMP,gen=FEM,per=2,voice=ACT,num=SG iḥriqī
ʾahrubu pos=V,mood=SBJV,gen=FEM,per=2,voice=ACT,num=SG tahrubī
ʾaḥsanti pos=V,mood=IND,gen=FEM,per=3,voice=PASS,num=PL,aspect=IPFV yuḥsanna
ʾaḥsantumā pos=V,mood=IND,tense=PST,gen=FEM,per=2,voice=ACT,num=PL,aspect=IPFV ʾaḥsantunna
ʾaḥsantum pos=V,mood=IND,tense=PST,gen=MASC,per=1,voice=ACT,num=PL,aspect=IPFV ʾaḥsannā
ʾaḥsastum pos=V,mood=SBJV,gen=MASC,per=3,voice=ACT,num=SG yuḥissa
ʾaḥsin pos=V,mood=IMP,gen=FEM,per=2,voice=ACT,num=PL ʾaḥsinna
ʾaḥšuda pos=V,mood=IND,tense=PST,gen=FEM,per=2,voice=PASS,num=SG,aspect=IPFV ḥušidti
ʾaḥṣula pos=V,mood=SBJV,gen=MASC,per=2,voice=ACT,num=DU taḥṣulā
ʾaḥtamila pos=V,mood=IND,tense=PRS,gen=MASC,per=2,voice=ACT,num=SG,aspect=IPFV taḥtamilu
ʾaḥtāṭa pos=V,mood=IND,tense=PRS,gen=MASC,per=2,voice=ACT,num=DU,aspect=IPFV taḥtāṭāni
ʾaḥuṭṭa pos=V,mood=IND,tense=PRS,gen=MASC,per=3,voice=PASS,num=SG,aspect=IPFV yuḥaṭṭu
ʾaḥuṭṭu pos=V,mood=IND,tense=PRS,gen=MASC,per=3,voice=ACT,num=DU,aspect=IPFV yaḥuṭṭāni
ʾaḥūṭu pos=V,mood=IND,tense=PST,gen=FEM,per=3,voice=PASS,num=PL,aspect=IPFV ḥiṭna
ʾaḥwajat pos=V,mood=IND,tense=PST,gen=MASC,per=3,voice=PASS,num=SG,aspect=IPFV ʾuḥwija
ʾaḥwajta pos=V,mood=IMP,gen=MASC,per=2,voice=ACT,num=PL ʾaḥwijū
ʾaḥwāšun pos=N,def=INDF,case=NOM,num=PL ʾaḥwāš
ʾaḥwijū pos=V,mood=IND,tense=PST,gen=FEM,per=3,voice=PASS,num=SG,aspect=IPFV ʾuḥwijat
ʾahwiyata pos=N,def=INDF,case=NOM,num=DU hawāʾayn
ʾahwiyatun pos=N,poss=PSSD,case=NOM,num=DU hawāʾay
ʾaḥyāʾan pos=ADJ,def=DEF,case=ACC,gen=MASC,num=SG al-ḥayya
ʾaḥya pos=V,mood=IND,tense=PRS,gen=FEM,per=3,voice=ACT,num=PL,aspect=IPFV yaḥyayna
ʾaḥzāba pos=N,def=DEF,case=GEN,num=SG al-ḥizbi
ʿāʾila pos=N,def=DEF,case=GEN,num=DU al-ʿāʾilatayni
ʿāʾilatāni pos=N,def=DEF,case=NOM,num=PL al-ʿawāʾil
ʿāʾilata pos=N,def=DEF,case=NOM,num=PL al-ʿawāʾilu
ʿāʾilatayni pos=N,def=DEF,case=GEN,num=SG al-ʿāʾilati
ʿāʾilatin pos=N,poss=PSSD,case=ACC,num=DU ʿāʾilatay
ʾaʿīrā pos=V,mood=SBJV,gen=FEM,per=2,voice=PASS,num=SG tuʿārī
ʾaʿir pos=V,mood=IND,gen=MASC,per=2,voice=PASS,num=PL,aspect=IPFV tuʿārū
ʾajabna pos=V,mood=IND,tense=PRS,gen=FEM,per=2,voice=ACT,num=DU,aspect=IPFV tujībāni
ʾajabtumā pos=V,mood=IND,tense=PST,gen=MASC,per=3,voice=ACT,num=SG,aspect=IPFV ʾajāba
ʾaʿjabu pos=V,mood=IND,gen=MASC,per=1,voice=ACT,num=PL,aspect=IPFV naʿjab
ʿajala pos=N,def=DEF,case=NOM,num=DU al-ʿajalatayn
ʾaʿjāmin pos=ADJ,def=DEF,case=GEN,gen=MASC,num=SG al-ʿajamiyyi
ʿajamiyyatayni pos=ADJ,def=DEF,case=GEN,gen=FEM,num=SG al-ʿajamiyyati
ʿajamiyyatayni pos=ADJ,def=DEF,case=NOM,gen=MASC,num=PL al-ʾaʿjām
ʿajamiyyatayn pos=ADJ,def=DEF,case=NOM,gen=FEM,num=SG al-ʿajamiyya
ʿajamiyyatin pos=ADJ,def=INDF,case=GEN,gen=FEM,num=DU ʿajamiyyatayni
ʾaʿjamtu pos=V,mood=IND,tense=PST,gen=FEM,per=2,voice=ACT,num=SG,aspect=IPFV ʾaʿjamti
ʾājara pos=V,mood=IND,tense=PST,gen=FEM,per=2,voice=ACT,num=PL,aspect=IPFV ʾājartunna
ʾajbur pos=V,mood=IND,tense=PST,gen=FEM,per=3,voice=ACT,num=DU,aspect=IPFV jabaratā
ʾajhadat pos=V,mood=SBJV,gen=FEM,per=2,voice=PASS,num=PL tujhadna
ʾajhadta pos=V,mood=IND,gen=MASC,per=3,voice=PASS,num=SG,aspect=IPFV yujhad
ʾajhidī pos=V,mood=SBJV,gen=FEM,per=2,voice=ACT,num=PL tujhidna
ʾajhidna pos=V,mood=IND,gen=MASC,per=3,voice=PASS,num=DU,aspect=IPFV yujhadā
ʿajībatan pos=ADJ,def=INDF,case=NOM,gen=FEM,num=PL ʿajībātun
ʾaʿjibī pos=V,mood=IND,tense=PRS,gen=FEM,per=2,voice=PASS,num=SG,aspect=IPFV tuʿjabīna
ʿajibnā pos=V,mood=IMP,gen=MASC,per=2,voice=ACT,num=SG iʿjab
ʾajibna pos=V,mood=IND,gen=FEM,per=2,voice=ACT,num=DU,aspect=IPFV tujībā
ʿajibna pos=V,mood=SBJV,gen=MASC,per=2,voice=ACT,num=PL taʿjabū
ʿajibtum pos=V,mood=IND,tense=PST,gen=FEM,per=3,voice=ACT,num=SG,aspect=IPFV ʿajibat
ʿajibtunna pos=V,mood=IND,tense=PST,gen=FEM,per=3,voice=ACT,num=PL,aspect=IPFV ʿajibna
ʿajibtu pos=V,mood=IND,tense=PRS,gen=MASC,per=1,voice=ACT,num=SG,aspect=IPFV ʾaʿjabu
ʾaʿjibū pos=V,mood=SBJV,gen=MASC,per=3,voice=ACT,num=SG yuʿjiba
ʾaʿjimī pos=V,mood=IND,tense=PRS,gen=MASC,per=2,voice=PASS,num=PL,aspect=IPFV tuʿjamūna
ʾaʿjimī pos=V,mood=IND,tense=PRS,gen=MASC,per=3,voice=ACT,num=PL,aspect=IPFV yuʿjimūna
ʾaʿjimna pos=V,voice=ACT muʿjim
ʾajirna pos=V,mood=IND,tense=PST,gen=MASC,per=3,voice=PASS,num=SG,aspect=IPFV ʾujīra
ʾājir pos=V,mood=IMP,gen=MASC,per=2,voice=ACT,num=DU ʾājirā
ʿajjabna pos=V,mood=SBJV,gen=FEM,per=3,voice=ACT,num=DU tuʿajjibā
ʿajjabti pos=V,mood=IND,tense=PST,gen=MASC,per=3,voice=ACT,num=SG,aspect=IPFV ʿajjaba
ʾajladā pos=V,mood=IND,gen=FEM,per=3,voice=PASS,num=DU,aspect=IPFV tujladā
ʾajladat pos=V,mood=IND,gen=FEM,per=1,voice=ACT,num=PL,aspect=IPFV nujlid
ʾajladnā pos=V,mood=IND,tense=PRS,gen=FEM,per=2,voice=ACT,num=DU,aspect=IPFV tujlidāni
ʾajladti pos=V,mood=IND,tense=PST,gen=MASC,per=2,voice=PASS,num=SG,aspect=IPFV ʾujlidta
ʾajladtunna pos=V,mood=SBJV,gen=MASC,per=2,voice=ACT,num=DU tujlidā
ʾajmalna pos=V,mood=IND,tense=PST,gen=MASC,per=1,voice=PASS,num=SG,aspect=IPFV ʾujmiltu
ʾajmalti pos=V,mood=IND,gen=FEM,per=2,voice=PASS,num=SG,aspect=IPFV tujmalī
ʾajmilā pos=V,mood=SBJV,gen=MASC,per=2,voice=PASS,num=DU tujmalā
ʾajmil pos=V,mood=IND,tense=PST,gen=FEM,per=1,voice=PASS,num=SG,aspect=IPFV ʾujmiltu
ʾajnādun pos=N,def=DEF,case=NOM,num=PL al-ʾajnādu
ʾajsādan pos=N,def=DEF,case=NOM,num=PL al-ʾajsād
ʾajūʿa pos=V,mood=IMP,gen=FEM,per=2,voice=ACT,num=PL juʿna
ʾajūʿa pos=V,mood=SBJV,gen=MASC,per=3,voice=PASS,num=DU yujāʿā
ʾajub pos=V,mood=IND,tense=PST,gen=MASC,per=3,voice=PASS,num=SG,aspect=IPFV jība
ʿajūlin pos=ADJ,def=DEF,case=NOM,gen=MASC,num=PL al-ʿujulu
ʾajuʿ pos=V,mood=IND,gen=MASC,per=1,voice=ACT,num=PL,aspect=IPFV najuʿ
ʾajwāḵi pos=N,poss=PSSD,case=ACC,num=DU jūḵay
ʾajwāḵ pos=N,poss=PSSD,case=GEN,num=PL ʾajwāḵi
ʾajwāḵun pos=N,def=DEF,case=NOM,num=SG al-jūḵ
ʾajzāʾa pos=N,def=INDF,case=NOM,num=PL ʾajzāʾun
ʾajzāʾun pos=N,poss=PSSD,case=ACC,num=DU juzʾay
ʾajziya pos=V,mood=IND,gen=MASC,per=3,voice=PASS,num=SG,aspect=IPFV yujza
ʾāḵaḏa pos=V,mood=SBJV,gen=MASC,per=1,voice=PASS,num=PL nuʾāḵaḏa
ʾāḵaḏtunna pos=V,mood=IND,gen=MASC,per=3,voice=PASS,num=DU,aspect=IPFV yuʾāḵaḏā
ʾaḵafna pos=V,voice=ACT muḵīf
ʾakala pos=V,mood=IND,tense=PST,gen=MASC,per=3,voice=PASS,num=PL,aspect=IPFV ʾukilū
ʾakaltunna pos=V,mood=IMP,gen=FEM,per=2,voice=ACT,num=DU kulā
ʾakaltunna pos=V,mood=SBJV,gen=MASC,per=2,voice=PASS,num=SG tuʾkala
ʿākasna pos=V,mood=IND,gen=FEM,per=3,voice=PASS,num=DU,aspect=IPFV tuʿākasā
ʿākasna pos=V,mood=IND,tense=PST,gen=FEM,per=1,voice=ACT,num=SG,aspect=IPFV ʿākastu
ʿākasta pos=V,mood=IND,tense=PST,gen=MASC,per=2,voice=ACT,num=PL,aspect=IPFV ʿākastum
ʾakbaran pos=ADJ,def=DEF,case=NOM,gen=FEM,num=DU al-ʾakbaratāni
ʾaḵbarna pos=V,mood=SBJV,gen=FEM,per=2,voice=PASS,num=PL tuḵbarna
ʾakbarun pos=ADJ,def=DEF,case=GEN,gen=MASC,num=SG al-ʾakbari
ʾaḵbirī pos=V,mood=IND,gen=FEM,per=3,voice=ACT,num=SG,aspect=IPFV tuḵbir
ʾakbisa pos=V,mood=SBJV,gen=FEM,per=1,voice=ACT,num=PL nakbisa
ʾaḵḍaltumā pos=V,mood=IND,gen=FEM,per=2,voice=ACT,num=SG,aspect=IPFV tuḵḍilī
ʾaḵḍaltum pos=V,mood=IND,gen=FEM,per=2,voice=ACT,num=DU,aspect=IPFV tuḵḍilā
ʾaḵḍaltu pos=V,mood=IND,gen=MASC,per=1,voice=PASS,num=SG,aspect=IPFV ʾuḵḍal
ʾaḵḍar pos=ADJ,def=INDF,case=NOM,gen=FEM,num=PL ḵuḍrun
ʾakḏiba pos=V,mood=IND,tense=PST,gen=MASC,per=1,voice=ACT,num=PL,aspect=IPFV kaḏabnā
ʾaḵḍilū pos=V,mood=IND,gen=FEM,per=1,voice=PASS,num=PL,aspect=IPFV nuḵḍal
ʾaḵdimu pos=V,mood=IND,gen=FEM,per=1,voice=ACT,num=PL,aspect=IPFV naḵdim
ʾaḵfaytumā pos=V,mood=IND,tense=PST,gen=MASC,per=1,voice=PASS,num=PL,aspect=IPFV ʾuḵfīnā
ʾaḵfaytunna pos=V,voice=PASS muḵfan
ʾaḵfaytu pos=V,mood=IND,gen=FEM,per=2,voice=PASS,num=DU,aspect=IPFV tuḵfayā
ʾaḵfi pos=V,mood=IND,gen=FEM,per=2,voice=PASS,num=SG,aspect=IPFV tuḵfay
ʾaḵfū pos=V,mood=IND,tense=PST,gen=FEM,per=2,voice=PASS,num=PL,aspect=IPFV ʾuḵfītunna
ʾaḵīratan pos=ADJ,def=DEF,case=ACC,gen=MASC,num=DU al-ʾaḵīrayni
ʿākisā pos=V,mood=SBJV,gen=MASC,per=1,voice=PASS,num=SG ʾuʿākasa
ʿākis pos=V,mood=IND,gen=FEM,per=2,voice=PASS,num=SG,aspect=IPFV tuʿākasī
ʾakkadatā pos=V,mood=SBJV,gen=MASC,per=1,voice=PASS,num=SG ʾuʾakkada
ʾakkadna pos=V,mood=IND,gen=MASC,per=2,voice=ACT,num=DU,aspect=IPFV tuʾakkidā
ʾakkalna pos=V,mood=IND,gen=FEM,per=1,voice=PASS,num=SG,aspect=IPFV ʾuʾakkal
ʾakkidā pos=V,mood=SBJV,gen=FEM,per=2,voice=PASS,num=SG tuʾakkadī
ʾakkidū pos=V,mood=IND,tense=PST,gen=MASC,per=2,voice=ACT,num=PL,aspect=IPFV ʾakkadtum
ʾakkilū pos=V,mood=SBJV,gen=MASC,per=2,voice=PASS,num=SG tuʾakkala
ʾaḵladatā pos=V,mood=IND,gen=MASC,per=1,voice=ACT,num=SG,aspect=IPFV ʾuḵlid
ʾaḵladnā pos=V,mood=IND,tense=PRS,gen=MASC,per=3,voice=ACT,num=DU,aspect=IPFV yuḵlidāni
ʾaḵladtumā pos=V,voice=ACT muḵlid
ʾaḵlidna pos=V,mood=IND,tense=PRS,gen=FEM,per=1,voice=PASS,num=SG,aspect=IPFV ʾuḵladu
ʾaḵlidna pos=V,mood=IND,tense=PST,gen=MASC,per=3,voice=ACT,num=SG,aspect=IPFV ʾaḵlada
ʾaḵmartu pos=V,mood=IND,gen=MASC,per=2,voice=PASS,num=SG,aspect=IPFV tuḵmar
ʾakrahna pos=V,mood=SBJV,gen=FEM,per=2,voice=PASS,num=SG tukrahī
ʾakrahtu pos=V,mood=IND,tense=PST,gen=FEM,per=2,voice=PASS,num=DU,aspect=IPFV ʾukrihtumā
ʾaḵrajtum pos=V,mood=IND,tense=PRS,gen=MASC,per=1,voice=PASS,num=PL,aspect=IPFV nuḵraju
ʾaḵrajtu pos=V,mood=IND,tense=PRS,gen=MASC,per=3,voice=PASS,num=SG,aspect=IPFV yuḵraju
ʾakramā pos=V,mood=IND,tense=PST,gen=FEM,per=2,voice=PASS,num=SG,aspect=IPFV ʾukrimti
ʾaḵranmis pos=V,mood=IND,gen=MASC,per=2,voice=ACT,num=SG,aspect=IPFV taḵranmis
ʾaḵranmis pos=V,mood=SBJV,gen=FEM,per=3,voice=ACT,num=SG taḵranmisa
ʾaḵranṭimu pos=V,mood=IMP,gen=MASC,per=2,voice=ACT,num=DU iḵranṭimā
ʾaḵrawwiṭ pos=V,mood=IND,tense=PRS,gen=MASC,per=3,voice=ACT,num=SG,aspect=IPFV yaḵrawwiṭu
ʾakruba pos=V,mood=IND,tense=PRS,gen=FEM,per=1,voice=PASS,num=SG,aspect=IPFV ʾukrabu
ʾakrub pos=V,mood=IMP,gen=MASC,per=2,voice=ACT,num=SG ukrub
ʾakšifa pos=V,mood=SBJV,gen=MASC,per=2,voice=PASS,num=PL tukšafū
ʾaktabā pos=V,mood=IND,gen=FEM,per=2,voice=PASS,num=PL,aspect=IPFV tuktabna
ʾaktabna pos=V,mood=IND,tense=PRS,gen=MASC,per=2,voice=PASS,num=PL,aspect=IPFV tuktabūna
ʾaktabtunna pos=V,mood=IND,tense=PST,gen=MASC,per=1,voice=PASS,num=SG,aspect=IPFV ʾuktibtu
ʾaktabtu pos=V,mood=IND,tense=PRS,gen=FEM,per=1,voice=PASS,num=SG,aspect=IPFV ʾuktabu
ʾaktabū pos=V,mood=IND,tense=PST,gen=MASC,per=2,voice=ACT,num=PL,aspect=IPFV ʾaktabtum
ʾaktaḥila pos=V,mood=IND,gen=FEM,per=2,voice=ACT,num=PL,aspect=IPFV taktaḥilna
ʾaḵṭāran pos=N,poss=PSSD,case=GEN,num=PL ʾaḵṭāri
ʾaḵṭāri pos=N,def=INDF,case=NOM,num=DU ḵaṭarayn
ʾaḵṭāru pos=N,def=DEF,case=GEN,num=SG al-ḵaṭari
ʾākul pos=V,mood=SBJV,gen=FEM,per=1,voice=ACT,num=SG ʾākula
ʾākul pos=V,mood=SBJV,gen=FEM,per=2,voice=PASS,num=SG tuʾkalī
ʾakwābi pos=N,poss=PSSD,case=GEN,num=SG kūbi
al-ʾaʿāṣīra pos=N,poss=PSSD,case=NOM,num=DU ʾiʿṣāray
al-ʾabada pos=N,def=INDF,case=NOM,num=DU ʾabadāni
al-ʾabadayni pos=N,def=INDF,case=NOM,num=SG ʾabad
al-ʾābāṭu pos=N,def=INDF,case=NOM,num=PL ʾābāṭ
al-ʾaʿbāʾu pos=N,poss=PSSD,case=NOM,num=SG ʿibʾu
al-ʾabāžūrātu pos=N,def=INDF,case=NOM,num=DU ʾabāžūrayn
al-ʾabāžūrayni pos=N,def=DEF,case=NOM,num=SG al-ʾabāžūru
al-ʾabāžūru pos=N,def=DEF,case=NOM,num=DU al-ʾabāžūrāni
al-ʿabbāsatayn pos=ADJ,def=DEF,case=NOM,gen=FEM,num=PL al-ʿabbāsātu
al-ʾabjadiyyīna pos=ADJ,def=DEF,case=GEN,gen=FEM,num=DU al-ʾabjadiyyatayni
al-ʾabjadiyyūna pos=ADJ,def=INDF,case=NOM,gen=MASC,num=PL ʾabjadiyyūna
al-ʾablahayni pos=ADJ,def=DEF,case=GEN,gen=FEM,num=DU al-balhāʾayni
al-ʾablahi pos=ADJ,def=DEF,case=GEN,gen=FEM,num=PL al-bulhi
ʾalʿabū pos=V,mood=IND,tense=PRS,gen=FEM,per=3,voice=ACT,num=DU,aspect=IPFV tulʿibāni
al-ʾabyaḍa pos=ADJ,def=INDF,case=ACC,gen=FEM,num=SG bayḍāʾa
al-ʾabzana pos=N,def=INDF,case=NOM,num=SG ʾabzanun
al-ʿaḍala pos=N,def=DEF,case=ACC,num=PL al-ʿaḍalāti
al-ʿadami pos=N,poss=PSSD,case=NOM,num=DU ʿadamay
al-ʾādamiyyāt pos=ADJ,def=DEF,case=GEN,gen=MASC,num=SG al-ʾādamiyyi
al-ʾādamiyyīna pos=ADJ,def=DEF,case=GEN,gen=FEM,num=DU al-ʾādamiyyatayni
al-ʿadamu pos=N,def=INDF,case=NOM,num=DU ʿadamayn
al-ʿadasata pos=N,poss=PSSD,case=ACC,num=SG ʿadasata
al-ʿadasatayni pos=N,def=INDF,case=NOM,num=DU ʿadasatāni
al-ʿadasati pos=N,def=DEF,case=NOM,num=SG al-ʿadasa
al-ʾaḍdādu pos=N,def=INDF,case=NOM,num=PL ʾaḍdādun
al-adʿiyati pos=N,poss=PSSD,case=ACC,num=PL adʿiyata
al-ʿādiyyāni pos=ADJ,def=INDF,case=NOM,gen=FEM,num=DU ʿādiyyatayn
al-ʿādiyyatāni pos=ADJ,def=INDF,case=ACC,gen=MASC,num=SG ʿādiyyan
al-ʿādiyyīn pos=ADJ,def=DEF,case=NOM,gen=MASC,num=DU al-ʿādiyyayn
al-ʿādiyyu pos=ADJ,def=DEF,case=NOM,gen=MASC,num=SG al-ʿādī
al-ʿaduww pos=N,def=INDF,case=NOM,num=PL ʾaʿdāʾ
al-ʾāfatāni pos=N,def=DEF,case=GEN,num=PL al-ʾāfāti
al-ʾāfatāni pos=N,def=INDF,case=NOM,num=PL ʾāfāt
al-ʾafḡāniyyata pos=ADJ,def=INDF,case=NOM,gen=MASC,num=DU ʾafḡāniyyayn
al-ʾafḡāniyyāt pos=ADJ,def=INDF,case=GEN,gen=FEM,num=SG ʾafḡāniyyatin
al-ʾafḡāniyyātu pos=ADJ,def=DEF,case=NOM,gen=FEM,num=PL al-ʾafḡāniyyāt
al-ʾafʾidatu pos=N,def=DEF,case=GEN,num=DU al-fuʾādayni
al-ʾaflāku pos=N,def=INDF,case=ACC,num=SG falakan
al-ʾaflāmu pos=N,poss=PSSD,case=ACC,num=DU filmay
al-ʾafrāsi pos=N,def=DEF,case=NOM,num=PL al-ʾafrāsu
al-ʾaḡbar pos=ADJ,def=DEF,case=NOM,gen=FEM,num=PL al-ḡubru
al-ʾaḡdiyatu pos=N,poss=PSSD,case=NOM,num=PL ʾaḡdiyatu
al-ʾaḡlāṭ pos=ADJ,def=DEF,case=ACC,gen=FEM,num=PL al-ḡalaṭāti
al-ʿahda pos=N,def=INDF,case=NOM,num=DU ʿahdayn
al-ʾaḥḏiya pos=N,poss=PSSD,case=ACC,num=SG ḥiḏāʾa
al-ʾaḥḏiyati pos=N,poss=PSSD,case=NOM,num=PL ʾaḥḏiyat
al-ʾaḥnāku pos=N,def=INDF,case=ACC,num=DU ḥanakayni
al-ʾaḥzābi pos=N,def=DEF,case=NOM,num=SG al-ḥizbu
al-ʾaʾimma pos=N,def=DEF,case=NOM,num=SG al-ʾimāmu
al-ʿajalatayn pos=N,poss=PSSD,case=NOM,num=PL ʿajalātu
al-ʿajamiyyatayn pos=ADJ,def=DEF,case=GEN,gen=FEM,num=DU al-ʿajamiyyatayni
al-ʿajamiyyati pos=ADJ,def=INDF,case=GEN,gen=FEM,num=DU ʿajamiyyatayni
al-ʾaʿjām pos=ADJ,def=INDF,case=ACC,gen=FEM,num=DU ʿajamiyyatayni
al-ʿajībatu pos=ADJ,def=INDF,case=NOM,gen=MASC,num=SG ʿajīb
al-ʾajnāda pos=N,def=DEF,case=GEN,num=PL al-ʾajnādi
al-ʾajnāda pos=N,poss=PSSD,case=NOM,num=DU junday
al-ʾajṯāṯa pos=N,def=INDF,case=ACC,num=SG juṯṯatan
al-ʾajwāf pos=N,poss=PSSD,case=NOM,num=SG jawf
al-ʾajyāfu pos=N,poss=PSSD,case=GEN,num=DU jīfatay
al-ʾakbaratāni pos=ADJ,def=INDF,case=ACC,gen=FEM,num=DU ʾakbaratayni
al-ʾaḵḍarāni pos=ADJ,def=DEF,case=NOM,gen=FEM,num=PL al-ḵuḍru
al-ʾaḵīratayn pos=ADJ,def=INDF,case=NOM,gen=MASC,num=SG ʾaḵīrun
al-ʾaḵīrāt pos=ADJ,def=INDF,case=GEN,gen=FEM,num=SG ʾaḵīratin
al-ʾaḵīratu pos=ADJ,def=DEF,case=ACC,gen=FEM,num=PL al-ʾaḵīrāti
al-ʾaḵīri pos=ADJ,def=INDF,case=GEN,gen=MASC,num=SG ʾaḵīrin
al-ʾaḵṭāri pos=N,def=DEF,case=NOM,num=DU al-ḵaṭarāni
al-ʾakuffa pos=N,poss=PSSD,case=GEN,num=DU kaffay
al-ʾakwāb pos=N,poss=PSSD,case=NOM,num=DU kūbay
al-ʿalājīm pos=N,def=INDF,case=NOM,num=SG ʿuljūmun
al-ʿalāqa pos=N,poss=PSSD,case=NOM,num=SG ʿalāqatu
al-ʿalāqātu pos=N,def=DEF,case=ACC,num=PL al-ʿalāqāti
al-ʿalāqatu pos=N,def=INDF,case=NOM,num=PL ʿalāqāt
al-ʾālāti pos=N,def=DEF,case=NOM,num=DU al-ʾālatāni
al-ʾālātu pos=N,def=INDF,case=NOM,num=DU ʾālatayn
al-ʿalawiyyatu pos=ADJ,def=DEF,case=ACC,gen=FEM,num=PL al-ʿalawiyyāti
al-ʿalawiyyayni pos=ADJ,def=INDF,case=NOM,gen=MASC,num=DU ʿalawiyyayn
al-ʾalifbāʾī pos=ADJ,def=INDF,case=GEN,gen=FEM,num=SG ʾalifbāʾiyyatin
al-ʾalifbāʾiyyati pos=ADJ,def=INDF,case=NOM,gen=MASC,num=PL ʾalifbāʾiyyīn
al-ʾalifbāʾiyyatu pos=ADJ,def=INDF,case=NOM,gen=MASC,num=DU ʾalifbāʾiyyayn
al-ʿalīmatāni pos=ADJ,def=DEF,case=GEN,gen=FEM,num=PL al-ʿalīmāti
al-ʿalīmata pos=ADJ,def=DEF,case=GEN,gen=MASC,num=SG al-ʿalīmi
al-ʿalīmayn pos=ADJ,def=DEF,case=GEN,gen=FEM,num=PL al-ʿalīmāti
al-ʿamāliqa pos=N,poss=PSSD,case=NOM,num=DU ʿimlāqay
al-ʿamaliyyāni pos=ADJ,def=DEF,case=NOM,gen=FEM,num=SG al-ʿamaliyya
al-ʿamaliyyāni pos=ADJ,def=INDF,case=GEN,gen=FEM,num=PL ʿamaliyyātin
al-ʿamaliyyati pos=N,poss=PSSD,case=NOM,num=SG ʿamaliyyat
ʾālamat pos=V,mood=IND,tense=PRS,gen=MASC,per=3,voice=ACT,num=PL,aspect=IPFV yuʾlimūna
al-ʾamīnāti pos=ADJ,def=DEF,case=NOM,gen=FEM,num=PL al-ʾamīnāt
al-ʾamīnu pos=N,poss=PSSD,case=NOM,num=DU ʾamīnay
al-ʿamīqa pos=ADJ,def=INDF,case=ACC,gen=MASC,num=DU ʿamīqayni
al-ʿamīqatu pos=ADJ,def=INDF,case=NOM,gen=FEM,num=DU ʿamīqatāni
al-ʿamīqi pos=ADJ,def=DEF,case=GEN,gen=FEM,num=PL al-ʿamīqāti
al-ʿāmiratayn pos=ADJ,def=INDF,case=ACC,gen=FEM,num=PL ʿāmirātin
al-ʿāmirāt pos=ADJ,def=INDF,case=ACC,gen=FEM,num=SG ʿāmiratan
al-ʿāmir pos=ADJ,def=DEF,case=ACC,gen=FEM,num=DU al-ʿāmiratayni
al-ʿāmmatāni pos=ADJ,def=DEF,case=GEN,gen=MASC,num=SG al-ʿāmmi
al-ʿāmmata pos=ADJ,def=INDF,case=GEN,gen=MASC,num=DU ʿāmmayni
al-ʿāmmiyyatāni pos=ADJ,def=DEF,case=ACC,gen=MASC,num=PL al-ʿāmmiyyīna
al-ʿāmmiyyayn pos=ADJ,def=INDF,case=NOM,gen=FEM,num=SG ʿāmmiyyatun
al-ʿāmmiyyi pos=ADJ,def=INDF,case=NOM,gen=FEM,num=PL ʿāmmiyyātun
ʾālamnā pos=V,mood=IND,gen=FEM,per=3,voice=PASS,num=DU,aspect=IPFV tuʾlamā
al-ʿām pos=N,def=INDF,case=GEN,num=PL ʾaʿwāmin
al-ʾamrayni pos=N,def=INDF,case=ACC,num=SG ʾamran
al-ʾamrīkī pos=ADJ,def=INDF,case=NOM,gen=FEM,num=SG ʾamrīkiyya
al-ʾamrīkiyyata pos=ADJ,def=DEF,case=NOM,gen=FEM,num=PL al-ʾamrīkiyyāt
al-ʾamrīkiyyatu pos=ADJ,def=DEF,case=NOM,gen=MASC,num=DU al-ʾamrīkiyyāni
al-ʾamyalayn pos=ADJ,def=INDF,case=ACC,gen=MASC,num=PL mīlan
al-ʾamzijata pos=N,poss=PSSD,case=ACC,num=SG mazāja
al-ʾanājīl pos=N,def=INDF,case=ACC,num=PL ʾanājīla
al-ʾanājiru pos=N,def=DEF,case=NOM,num=DU al-ʾanjarayn
al-ʾanājiru pos=N,def=INDF,case=ACC,num=PL ʾanājira
al-ʿanākiba pos=N,def=INDF,case=GEN,num=DU ʿankabūtayni
al-ʾanāniyyayn pos=ADJ,def=DEF,case=NOM,gen=MASC,num=SG al-ʾanānī
al-ʾanāniyyīna pos=ADJ,def=DEF,case=NOM,gen=FEM,num=PL al-ʾanāniyyāt
al-ʾanāniyyūna pos=ADJ,def=DEF,case=GEN,gen=FEM,num=DU al-ʾanāniyyatayni
al-ʾanbiḏati pos=N,poss=PSSD,case=NOM,num=PL ʾanbiḏatu
al-ʾanhāri pos=N,def=INDF,case=GEN,num=SG nahrin
al-ʾānisatayn pos=N,def=INDF,case=NOM,num=DU ʾānisatāni
al-ʾanjara pos=N,def=INDF,case=GEN,num=DU ʾanjarayni
al-ʾanjara pos=N,def=INDF,case=NOM,num=PL ʾanājir
al-ʾansāla pos=N,def=INDF,case=NOM,num=DU naslāni
al-ʾansāl pos=N,poss=PSSD,case=NOM,num=SG naslu
al-ʾanzāla pos=N,poss=PSSD,case=NOM,num=PL ʾanzālu
al-ʾaqālīma pos=N,poss=PSSD,case=GEN,num=SG ʾiqlīmi
ʿalāqatu pos=N,def=INDF,case=NOM,num=SG ʿalāqatun
al-ʿaqīdatu pos=N,poss=PSSD,case=NOM,num=DU ʿaqīdatay
al-ʿaqliyyāni pos=ADJ,def=INDF,case=ACC,gen=MASC,num=PL ʿaqliyyīna
al-ʿaqliyyūna pos=ADJ,def=INDF,case=NOM,gen=MASC,num=SG ʿaqliyyun
ʾalʿaq pos=V,mood=IND,tense=PRS,gen=MASC,per=3,voice=ACT,num=PL,aspect=IPFV yalʿaqūna
al-ʿaqrabayn pos=N,def=INDF,case=GEN,num=DU ʿaqrabayni
al-ʾaqribāʾi pos=N,def=DEF,case=ACC,num=PL al-ʾaqribāʾa
al-ʾaqtāli pos=N,poss=PSSD,case=GEN,num=PL ʾaqtāli
al-ʾaqwiyāʾ pos=ADJ,def=INDF,case=ACC,gen=FEM,num=PL qawiyyātin
al-ʾaqzāmu pos=N,poss=PSSD,case=GEN,num=SG qazami
al-ʾārāʾa pos=N,def=INDF,case=GEN,num=SG raʾyin
al-ʾarānibi pos=N,poss=PSSD,case=GEN,num=SG ʾarnabi
al-ʾārāʾ pos=N,poss=PSSD,case=ACC,num=PL ʾārāʾa
al-ʾarmidata pos=N,def=DEF,case=ACC,num=DU ar-ramādayni
al-ʾarmidati pos=N,def=INDF,case=NOM,num=PL ʾarmida
al-ʾarmidatu pos=N,poss=PSSD,case=NOM,num=SG ramād
al-ʾarmīniyyayni pos=ADJ,def=DEF,case=ACC,gen=FEM,num=PL al-ʾarmīniyyāti
al-ʾarmīniyyūna pos=ADJ,def=DEF,case=GEN,gen=FEM,num=SG al-ʾarmīniyyati
al-ʾarnabāni pos=N,def=DEF,case=GEN,num=PL al-ʾarānibi
al-ʾarṣida pos=N,poss=PSSD,case=NOM,num=PL ʾarṣidatu
al-ʿarūsi pos=N,def=INDF,case=NOM,num=PL ʿarāʾisu
al-ʿarūs pos=N,poss=PSSD,case=ACC,num=DU ʿarūsay
al-ʾarʾusu pos=N,def=DEF,case=NOM,num=PL al-ʾarʾus
al-ʿaṣaba pos=N,def=DEF,case=GEN,num=SG al-ʿaṣabi
al-ʿaṣabayni pos=N,poss=PSSD,case=ACC,num=DU ʿaṣabay
al-ʾasābīʿi pos=N,def=DEF,case=ACC,num=PL al-ʾasābīʿa
al-ʾaṣābiʿ pos=N,def=INDF,case=ACC,num=PL ʾaṣābiʿa
al-ʿasabiyyatāni pos=ADJ,def=DEF,case=ACC,gen=MASC,num=DU al-ʿasabiyyayni
al-ʿasabiyyatayn pos=ADJ,def=INDF,case=GEN,gen=FEM,num=PL ʿasabiyyātin
al-ʿaṣāfīru pos=N,poss=PSSD,case=GEN,num=SG ʿaṣfūri
al-ʾasāsiyyāni pos=ADJ,def=INDF,case=NOM,gen=MASC,num=PL ʾasāsiyyīn
al-ʾasāsiyyata pos=ADJ,def=DEF,case=ACC,gen=MASC,num=DU al-ʾasāsiyyayni
al-ʾasdāsa pos=N,poss=PSSD,case=NOM,num=SG sudsu
al-ʾasdāsu pos=N,def=DEF,case=NOM,num=DU as-sudsāni
al-aṣdiqāʾu pos=N,poss=PSSD,case=NOM,num=SG ṣadīq
al-ʾaṣfara pos=ADJ,def=INDF,case=GEN,gen=FEM,num=PL ṣufrin
al-ʾaṣfari pos=ADJ,def=DEF,case=NOM,gen=MASC,num=PL aṣ-ṣufr
al-ʿaṣfūrayni pos=N,poss=PSSD,case=NOM,num=DU ʿaṣfūrā
al-ʿāṣifa pos=N,def=DEF,case=ACC,num=PL al-ʿawāṣifa
al-ʿāṣima pos=N,def=INDF,case=GEN,num=PL ʿawāṣima
al-ʿāṣimata pos=N,def=DEF,case=NOM,num=SG al-ʿāṣimatu
al-ʿašīrati pos=N,def=INDF,case=GEN,num=DU ʿašīratayni
al-ʿāširāt pos=ADJ,def=DEF,case=ACC,gen=FEM,num=PL al-ʿāširāti
al-ʾaškāla pos=N,poss=PSSD,case=GEN,num=SG šakli
al-ʾaškāla pos=N,poss=PSSD,case=NOM,num=SG šakl
al-ʾasliḥa pos=N,def=INDF,case=NOM,num=PL ʾasliḥatun
al-ʾasliḥati pos=N,poss=PSSD,case=NOM,num=SG silāḥ
al-ʾaṣliyyīna pos=ADJ,def=INDF,case=GEN,gen=MASC,num=PL ʾaṣliyyīna
al-ʾaṣliyyu pos=ADJ,def=INDF,case=ACC,gen=FEM,num=SG ʾaṣliyyatan
al-ʾasrābi pos=N,def=DEF,case=NOM,num=SG as-sirb
al-ʾašrāṭ pos=ADJ,def=DEF,case=NOM,gen=FEM,num=SG aš-šarṭatu
al-ʾaštiyati pos=N,def=INDF,case=NOM,num=PL ʾaštiyatun
al-ʾaswāʾi pos=N,def=INDF,case=NOM,num=DU sūʾayn
al-ʾasyāfi pos=N,poss=PSSD,case=NOM,num=DU sīfā
al-ʾasyāfu pos=N,def=INDF,case=ACC,num=SG sīfan
al-ʾašyāʿi pos=N,def=DEF,case=ACC,num=DU aš-šīʿatayni
al-ʾaṯar pos=N,poss=PSSD,case=NOM,num=SG ʾaṯaru
al-ʿāṭifi pos=N,def=INDF,case=ACC,num=SG ʿāṭifan
ʾālati pos=N,def=DEF,case=NOM,num=SG al-ʾāla
ʾālati pos=N,def=INDF,case=NOM,num=DU ʾālatāni
al-ʾaṭmāʿi pos=N,poss=PSSD,case=NOM,num=SG ṭamaʿu
ʾālāt pos=N,def=DEF,case=ACC,num=DU al-ʾālatayni
al-ʾaṭrāba pos=N,def=DEF,case=ACC,num=SG aṭ-ṭaraba
al-ʾaṭrāb pos=N,def=DEF,case=NOM,num=PL al-ʾaṭrābu
al-ʾaṭrašāni pos=ADJ,def=DEF,case=GEN,gen=MASC,num=PL aṭ-ṭurši
ʾālātu pos=N,def=DEF,case=ACC,num=DU al-ʾālatayni
ʾālātu pos=N,poss=PSSD,case=NOM,num=DU ʾālatay
al-ʾaṯwāba pos=N,poss=PSSD,case=GEN,num=DU ṯawbay
al-ʾaṭyāru pos=N,def=INDF,case=NOM,num=PL ʾaṭyār
al-ʾaʿwāmi pos=N,def=DEF,case=GEN,num=DU al-ʿāmayni
al-ʾawānisu pos=N,def=DEF,case=ACC,num=SG al-ʾānisata
al-ʾawānisu pos=N,def=DEF,case=NOM,num=DU al-ʾānisatāni
al-ʿawāṣima pos=N,poss=PSSD,case=NOM,num=PL ʿawāṣimu
al-ʿawāṣimi pos=N,def=INDF,case=NOM,num=SG ʿāṣima
al-ʿawāṣimu pos=N,poss=PSSD,case=NOM,num=SG ʿāṣimatu
ʿalawiyyāni pos=ADJ,def=DEF,case=ACC,gen=FEM,num=DU al-ʿalawiyyatayni
al-ʾawizatayn pos=N,def=DEF,case=NOM,num=DU al-ʾawizatāni
al-ʾawizu pos=N,def=DEF,case=GEN,num=SG al-ʾawizati
al-ʾawqāta pos=N,def=DEF,case=ACC,num=SG al-waqta
al-ʿawrāʾāni pos=ADJ,def=DEF,case=GEN,gen=MASC,num=PL al-ʿūri
al-ʿawrāt pos=N,poss=PSSD,case=GEN,num=DU ʿawratay
al-ʾawṭān pos=N,poss=PSSD,case=ACC,num=SG waṭana
ʿalawtunna pos=V,mood=IND,gen=FEM,per=1,voice=ACT,num=PL,aspect=IPFV naʿlu
al-ʾāyata pos=N,poss=PSSD,case=ACC,num=PL ʾāyāti
al-ʾāyatayn pos=N,def=DEF,case=GEN,num=PL al-ʾāyāti
al-ʾāyatayn pos=N,poss=PSSD,case=ACC,num=DU ʾāyatay
al-ʾāyātu pos=N,poss=PSSD,case=NOM,num=DU ʾāyatay
al-ʾaymāna pos=N,def=INDF,case=NOM,num=DU yamīnāni
al-ʾaytāma pos=N,def=DEF,case=NOM,num=PL al-ʾaytāmu
al-ʾaytāma pos=N,poss=PSSD,case=ACC,num=SG yatīma
al-ʾayūnāt pos=N,def=INDF,case=NOM,num=DU ʾayūnayn
al-ʾayūnu pos=N,poss=PSSD,case=NOM,num=SG ʾayūn
al-ʾaʿzabāni pos=ADJ,def=DEF,case=NOM,gen=FEM,num=SG al-ʿazbāʾu
al-ʾaʿzāba pos=ADJ,def=DEF,case=ACC,gen=MASC,num=DU al-ʿazabayni
al-ʿazabati pos=ADJ,def=INDF,case=GEN,gen=FEM,num=PL ʿazabātin
al-ʾazaliyyāti pos=ADJ,def=DEF,case=NOM,gen=MASC,num=DU al-ʾazaliyyayn
al-ʾazaliyyāt pos=ADJ,def=DEF,case=GEN,gen=MASC,num=SG al-ʾazaliyyi
al-ʾazaliyyayni pos=ADJ,def=INDF,case=GEN,gen=FEM,num=PL ʾazaliyyātin
al-ʿazbāʾāni pos=ADJ,def=INDF,case=NOM,gen=FEM,num=PL ʿuzb
al-azbābi pos=N,def=INDF,case=ACC,num=PL azbāban
al-ʿaẓīmati pos=ADJ,def=DEF,case=NOM,gen=MASC,num=SG al-ʿaẓīmu
al-ʿaẓīmatu pos=ADJ,def=INDF,case=GEN,gen=MASC,num=DU ʿaẓīmayni
al-ʿaẓīmātu pos=ADJ,def=INDF,case=NOM,gen=MASC,num=DU ʿaẓīmāni
al-ʿaẓīmi pos=ADJ,def=DEF,case=NOM,gen=MASC,num=SG al-ʿaẓīm
al-ʿazīzātu pos=ADJ,def=DEF,case=ACC,gen=MASC,num=DU al-ʿazīzayni
al-ʿazīzātu pos=ADJ,def=INDF,case=NOM,gen=MASC,num=SG ʿazīzun
al-ʾazmāni pos=N,poss=PSSD,case=GEN,num=PL ʾazmāni
al-ʾazmān pos=N,poss=PSSD,case=GEN,num=DU zamanay
al-ʿaẓmi pos=N,def=INDF,case=ACC,num=PL ʿiẓāman
al-ʾazyāfi pos=ADJ,def=INDF,case=NOM,gen=FEM,num=PL zāʾifātun
al-ʾazyāfu pos=ADJ,def=INDF,case=GEN,gen=FEM,num=DU zāʾifatayni
al-babrāni pos=N,def=DEF,case=ACC,num=SG al-babra
al-babrayn pos=N,def=DEF,case=NOM,num=DU al-babrāni
al-babr pos=N,def=DEF,case=ACC,num=PL al-bubūra
al-babr pos=N,def=DEF,case=NOM,num=DU al-babrāni
al-baḍāʾiʿi pos=N,poss=PSSD,case=ACC,num=SG biḍāʿata
al-baḍāʾiʿu pos=N,def=DEF,case=NOM,num=DU al-biḍāʿatayn
al-badan pos=N,def=DEF,case=NOM,num=PL al-ʾabdān
al-badawiyyatāni pos=ADJ,def=DEF,case=NOM,gen=MASC,num=SG al-badawī
al-badawiyyāti pos=ADJ,def=INDF,case=NOM,gen=MASC,num=SG badawiyyun
al-badawiyyatu pos=ADJ,def=INDF,case=ACC,gen=FEM,num=PL badawiyyātin
al-bāḏinjān pos=N,poss=PSSD,case=GEN,num=DU bāḏinjānay
al-bahārātu pos=N,def=INDF,case=NOM,num=DU bahārāni
al-bahāru pos=N,def=INDF,case=NOM,num=DU bahārayn
al-baḥrayniyya pos=ADJ,def=DEF,case=GEN,gen=FEM,num=PL al-baḥrayniyyāti
al-baḥrayniyyīna pos=ADJ,def=DEF,case=NOM,gen=MASC,num=SG al-baḥraynī
al-baḥrayniyyu pos=ADJ,def=DEF,case=NOM,gen=MASC,num=SG al-baḥraynī
al-baʿīdatayni pos=ADJ,def=DEF,case=NOM,gen=MASC,num=DU al-baʿīdāni
al-baḵāšīš pos=N,def=INDF,case=GEN,num=DU baḵšīšayni
al-baḵīla pos=ADJ,def=INDF,case=NOM,gen=MASC,num=SG baḵīl
al-baḵīlayni pos=N,poss=PSSD,case=GEN,num=PL buḵalāʾi
al-baḵīl pos=ADJ,def=INDF,case=NOM,gen=MASC,num=DU baḵīlāni
al-baḵīlu pos=N,def=INDF,case=NOM,num=DU baḵīlāni
al-baḵšīš pos=N,def=DEF,case=NOM,num=DU al-baḵšīšayn
al-baḵšīš pos=N,def=INDF,case=ACC,num=DU baḵšīšayni
al-baladiyāt pos=N,poss=PSSD,case=NOM,num=PL baladiyātu
al-baladiyyatayn pos=N,def=DEF,case=GEN,num=SG al-baladiyyati
al-baladiyyatu pos=ADJ,def=INDF,case=NOM,gen=MASC,num=DU baladiyyāni
al-baladiyyīna pos=ADJ,def=INDF,case=ACC,gen=FEM,num=PL baladiyyātin
al-balhāʾu pos=ADJ,def=DEF,case=GEN,gen=FEM,num=DU al-balhāʾayni
al-banāti pos=N,def=DEF,case=NOM,num=SG al-bintu
al-bandarayni pos=N,poss=PSSD,case=NOM,num=DU bandarā
ʾalbāniyya pos=ADJ,def=INDF,case=NOM,gen=MASC,num=PL ʾalbāniyyīn
ʾalbāniyyātin pos=ADJ,def=DEF,case=GEN,gen=FEM,num=PL al-ʾalbāniyyāti
ʾalbāniyyayn pos=ADJ,def=INDF,case=GEN,gen=MASC,num=DU ʾalbāniyyayni
al-banka pos=N,def=INDF,case=NOM,num=PL bunūkun
al-baqāšīš pos=N,def=INDF,case=GEN,num=DU baqšīšayni
al-baqšīš pos=N,poss=PSSD,case=GEN,num=SG baqšīši
al-barbaḵayni pos=N,def=INDF,case=ACC,num=SG barbaḵan
al-barbariyyātu pos=ADJ,def=DEF,case=NOM,gen=MASC,num=SG al-barbariyyu
al-bāridatāni pos=ADJ,def=DEF,case=NOM,gen=MASC,num=DU al-bāridāni
al-bāridi pos=ADJ,def=INDF,case=ACC,gen=FEM,num=DU bāridatayni
al-bāridi pos=ADJ,def=INDF,case=GEN,gen=MASC,num=SG bāridin
al-bāridi pos=ADJ,def=INDF,case=NOM,gen=FEM,num=PL bāridāt
al-bāriza pos=ADJ,def=INDF,case=NOM,gen=FEM,num=DU bārizatāni
al-barlamāni pos=N,poss=PSSD,case=GEN,num=SG barlamāni
al-barzaḵāni pos=N,def=DEF,case=ACC,num=PL al-barāziḵa
al-bāṣa pos=N,def=DEF,case=NOM,num=SG al-bāṣ
al-bāṣi pos=N,poss=PSSD,case=NOM,num=DU bāṣā
al-basīṭati pos=ADJ,def=INDF,case=GEN,gen=MASC,num=DU basīṭayni
al-basīṭayn pos=ADJ,def=INDF,case=NOM,gen=MASC,num=SG basīṭun
al-baṭīʾi pos=ADJ,def=INDF,case=GEN,gen=FEM,num=PL baṭīʾātin
al-bāṭilatayni pos=ADJ,def=INDF,case=GEN,gen=FEM,num=SG bāṭilatin
al-bāṭilu pos=ADJ,def=INDF,case=NOM,gen=FEM,num=SG bāṭilatun
al-baydaqayni pos=N,def=DEF,case=ACC,num=PL al-bayādiqa
al-baydaqayn pos=N,poss=PSSD,case=GEN,num=SG baydaqi
al-baẓrayni pos=N,def=INDF,case=NOM,num=DU baẓrāni
al-baẓrayn pos=N,def=INDF,case=GEN,num=PL buẓūrin
al-baẓr pos=N,poss=PSSD,case=GEN,num=DU baẓray
al-baẓru pos=N,def=INDF,case=GEN,num=PL buẓūrin
al-bīʾatayn pos=N,def=INDF,case=ACC,num=SG bīʾatan
al-bīʾāti pos=N,def=INDF,case=ACC,num=DU bīʾatayni
al-bībān pos=N,def=DEF,case=ACC,num=SG al-bāba
al-bībānu pos=N,poss=PSSD,case=NOM,num=DU bābā
al-biḍāʿati pos=N,def=INDF,case=ACC,num=PL baḍāʾiʿa
al-biḏali pos=N,def=INDF,case=ACC,num=PL biḏalan
al-bidāyāt pos=N,def=DEF,case=NOM,num=DU al-bidāyatāni
al-bināyatayni pos=N,def=INDF,case=GEN,num=PL bināyātin
al-bināyatayn pos=N,def=DEF,case=NOM,num=SG al-bināya
al-bintayni pos=N,poss=PSSD,case=NOM,num=PL banātu
al-buḵāra pos=N,def=DEF,case=ACC,num=PL al-ʾabḵirata
al-bunduqiyyatayni pos=N,def=INDF,case=GEN,num=PL banādiqa
al-būqi pos=N,poss=PSSD,case=NOM,num=PL būqātu
al-burḡūṯāni pos=N,poss=PSSD,case=NOM,num=SG burḡūṯu
al-burḡūṯ pos=N,def=DEF,case=ACC,num=SG al-burḡūṯa
al-burhānayni pos=N,def=DEF,case=ACC,num=SG al-burhāna
al-bustānu pos=N,poss=PSSD,case=GEN,num=PL basātīni
al-buẓūri pos=N,def=INDF,case=NOM,num=PL buẓūr
al-faḍāʾiḥi pos=N,poss=PSSD,case=ACC,num=PL faḍāʾiḥa
al-faḍīḥa pos=N,def=DEF,case=NOM,num=DU al-faḍīḥatayn
al-faḍīḥatāni pos=N,def=DEF,case=NOM,num=SG al-faḍīḥatu
al-fāḥišati pos=N,def=INDF,case=NOM,num=DU fāḥišatayn
al-fāʾizatayn pos=ADJ,def=INDF,case=ACC,gen=FEM,num=DU fāʾizatayni
al-faḵiḏāni pos=N,poss=PSSD,case=GEN,num=DU faḵiḏay
al-faḵiḏu pos=N,poss=PSSD,case=NOM,num=PL ʾafḵāḏ
al-faḵūrāni pos=ADJ,def=INDF,case=GEN,gen=FEM,num=DU faḵūratayni
al-faḵūratāni pos=ADJ,def=INDF,case=NOM,gen=FEM,num=PL faḵūrāt
al-faḵūrātu pos=ADJ,def=DEF,case=NOM,gen=FEM,num=PL al-faḵūrāt
al-falakiyyatayn pos=ADJ,def=INDF,case=ACC,gen=MASC,num=SG falakiyyan
al-falakiyyāt pos=ADJ,def=DEF,case=NOM,gen=MASC,num=PL al-falakiyyūna
al-falakiyyatu pos=ADJ,def=DEF,case=NOM,gen=MASC,num=DU al-falakiyyayn
al-falakiyyayn pos=ADJ,def=INDF,case=NOM,gen=MASC,num=DU falakiyyayn
al-fanniyyīna pos=ADJ,def=DEF,case=NOM,gen=FEM,num=DU al-fanniyyatayn
al-fanniyyīn pos=ADJ,def=INDF,case=NOM,gen=MASC,num=DU fanniyyayn
al-fanniyyūna pos=ADJ,def=DEF,case=ACC,gen=MASC,num=PL al-fanniyyīna
al-fanniyyu pos=ADJ,def=DEF,case=GEN,gen=FEM,num=PL al-fanniyyāti
al-faqīha pos=N,def=DEF,case=NOM,num=DU al-faqīhayn
al-faqīhayni pos=N,def=DEF,case=NOM,num=PL al-fuqahāʾ
al-faqīratāni pos=ADJ,def=INDF,case=NOM,gen=MASC,num=SG faqīr
al-faqīrayn pos=ADJ,def=DEF,case=NOM,gen=FEM,num=PL al-faqīrātu
al-farādīsi pos=N,poss=PSSD,case=ACC,num=SG firdawsa
al-farāmili pos=N,poss=PSSD,case=NOM,num=DU farmalatay
al-farāmil pos=N,def=INDF,case=GEN,num=DU farmalatayni
al-faransiyyāni pos=ADJ,def=DEF,case=NOM,gen=FEM,num=PL al-faransiyyāt
al-faransiyyati pos=ADJ,def=DEF,case=NOM,gen=FEM,num=SG al-faransiyyatu
al-fardu pos=N,poss=PSSD,case=GEN,num=SG fardi
al-fāriʿatayni pos=ADJ,def=DEF,case=GEN,gen=FEM,num=SG al-fāriʿati
al-fāriʿāt pos=ADJ,def=DEF,case=NOM,gen=MASC,num=SG al-fāriʿu
al-fāriʿātu pos=ADJ,def=INDF,case=GEN,gen=MASC,num=DU fāriʿayni
al-fāriʿatu pos=ADJ,def=INDF,case=NOM,gen=MASC,num=DU fāriʿāni
al-farīdatāni pos=ADJ,def=INDF,case=NOM,gen=FEM,num=PL farīdātun
al-farīdatayn pos=ADJ,def=DEF,case=ACC,gen=FEM,num=SG al-farīdata
al-fāriḡatāni pos=ADJ,def=DEF,case=GEN,gen=MASC,num=DU al-fāriḡayni
al-fāriḡatu pos=ADJ,def=DEF,case=NOM,gen=FEM,num=DU al-fāriḡatāni
al-fāriḡātu pos=ADJ,def=INDF,case=NOM,gen=FEM,num=SG fāriḡatun
al-fariḥatu pos=ADJ,def=DEF,case=NOM,gen=FEM,num=DU al-fariḥatayn
al-fariḥīn pos=ADJ,def=INDF,case=GEN,gen=MASC,num=PL fariḥīna
al-fārisiyyatāni pos=ADJ,def=INDF,case=GEN,gen=FEM,num=DU fārisiyyatayni
al-fārisiyyātu pos=ADJ,def=INDF,case=ACC,gen=MASC,num=DU fārisiyyayni
al-fārisiyyayni pos=ADJ,def=DEF,case=ACC,gen=FEM,num=SG al-fārisiyyata
al-farj pos=N,def=INDF,case=ACC,num=DU farjayni
al-farmalatāni pos=N,def=INDF,case=NOM,num=SG farmalatun
al-farmalatayni pos=N,def=INDF,case=GEN,num=PL farāmila
al-farmalati pos=N,def=INDF,case=NOM,num=DU farmalatayn
al-fasātīna pos=N,def=DEF,case=NOM,num=SG al-fustān
al-fāšiyyata pos=ADJ,def=DEF,case=NOM,gen=FEM,num=DU al-fāšiyyatayn
al-fāšiyyatayni pos=ADJ,def=DEF,case=NOM,gen=FEM,num=SG al-fāšiyya
al-fāšiyyāti pos=ADJ,def=DEF,case=NOM,gen=MASC,num=DU al-fāšiyyāni
al-fāšiyyayni pos=ADJ,def=INDF,case=NOM,gen=MASC,num=PL fāšiyyūna
al-fātiḥatayni pos=ADJ,def=DEF,case=NOM,gen=FEM,num=SG al-fātiḥatu
al-fātiḥati pos=N,def=INDF,case=GEN,num=DU fātiḥatayni
al-fatratu pos=N,def=INDF,case=ACC,num=SG fatratan
al-fawātiḥi pos=N,def=DEF,case=ACC,num=SG al-fātiḥata
al-fikratayn pos=N,def=INDF,case=ACC,num=DU fikratayni
al-fīla pos=N,def=INDF,case=ACC,num=SG fīlan
al-filasṭīnī pos=ADJ,def=DEF,case=ACC,gen=FEM,num=PL al-filasṭīniyyāti
al-filasṭīnī pos=ADJ,def=DEF,case=NOM,gen=FEM,num=SG al-filasṭīniyya
al-filasṭīniyyatu pos=ADJ,def=INDF,case=GEN,gen=MASC,num=DU filasṭīniyyayni
al-filfilāni pos=N,poss=PSSD,case=NOM,num=DU filfilay
al-filfilāni pos=N,poss=PSSD,case=NOM,num=SG filfilu
al-filfil pos=N,poss=PSSD,case=ACC,num=DU filfilay
al-filma pos=N,poss=PSSD,case=GEN,num=PL ʾaflāmi
al-fīlu pos=N,def=INDF,case=GEN,num=SG fīlin
al-finlandiyyāni pos=ADJ,def=INDF,case=NOM,gen=FEM,num=PL finlandiyyātun
al-finlandiyyati pos=ADJ,def=DEF,case=GEN,gen=FEM,num=PL al-finlandiyyāti
al-finlandiyyayn pos=ADJ,def=INDF,case=ACC,gen=MASC,num=SG finlandiyyan
al-firāša pos=N,def=DEF,case=NOM,num=PL al-ʾafriša
al-firāšu pos=N,poss=PSSD,case=NOM,num=PL ʾafrišat
al-firdawsāni pos=N,def=INDF,case=GEN,num=SG firdawsin
al-firdaws pos=N,def=DEF,case=NOM,num=DU al-firdawsayn
al-firdaws pos=N,poss=PSSD,case=NOM,num=SG firdawsu
al-firmiyuna pos=N,poss=PSSD,case=NOM,num=PL firmiyunātu
al-fitnatāni pos=N,def=DEF,case=NOM,num=DU al-fitnatayn
al-fuʾāda pos=N,def=DEF,case=NOM,num=DU al-fuʾādāni
al-fuḍūliyyāni pos=ADJ,def=DEF,case=GEN,gen=FEM,num=SG al-fuḍūliyyati
al-fuḍūliyyatayni pos=ADJ,def=INDF,case=NOM,gen=MASC,num=PL fuḍūliyyūna
al-funūni pos=N,poss=PSSD,case=NOM,num=SG fann
al-funūnu pos=N,def=DEF,case=ACC,num=DU al-fannayni
al-furnayni pos=N,def=INDF,case=NOM,num=SG furn
al-furnayni pos=N,poss=PSSD,case=GEN,num=SG furni
al-furni pos=N,def=DEF,case=GEN,num=PL al-ʾafrāni
al-furn pos=N,def=DEF,case=NOM,num=DU al-furnāni
al-furn pos=N,poss=PSSD,case=GEN,num=PL ʾafrāni
al-furṣati pos=N,def=INDF,case=NOM,num=SG furṣa
al-furṣatu pos=N,def=INDF,case=ACC,num=PL furaṣan
al-fustāni pos=N,def=DEF,case=GEN,num=DU al-fustānayni
al-ḡābata pos=N,poss=PSSD,case=GEN,num=DU ḡābatay
al-ḡāʾibāni pos=ADJ,def=DEF,case=GEN,gen=MASC,num=DU al-ḡāʾibayni
al-ḡāʾibatayni pos=ADJ,def=INDF,case=ACC,gen=FEM,num=SG ḡāʾibatan
al-ḡāʾibāti pos=ADJ,def=INDF,case=ACC,gen=MASC,num=SG ḡāʾiban
al-ḡāʾib pos=ADJ,def=INDF,case=GEN,gen=FEM,num=DU ḡāʾibatayni
al-ḡāʾimu pos=ADJ,def=DEF,case=ACC,gen=FEM,num=SG al-ḡāʾimata
al-ḡalaṭa pos=ADJ,def=DEF,case=NOM,gen=MASC,num=PL al-ʾaḡlāṭu
al-ḡalaṭatayn pos=ADJ,def=INDF,case=NOM,gen=FEM,num=SG ḡalaṭatun
al-ḡalaṭ pos=ADJ,def=INDF,case=NOM,gen=FEM,num=DU ḡalaṭatāni
al-ḡalimāni pos=ADJ,def=DEF,case=GEN,gen=MASC,num=SG al-ḡalimi
al-ḡāliyyatayn pos=ADJ,def=INDF,case=NOM,gen=FEM,num=DU ḡāliyyatāni
al-ḡarāʾiz pos=N,def=INDF,case=NOM,num=PL ḡarāʾiz
al-ḡarbiyyatayni pos=ADJ,def=DEF,case=ACC,gen=MASC,num=DU al-ḡarbiyyayni
al-ḡarbiyyāt pos=ADJ,def=DEF,case=GEN,gen=FEM,num=SG al-ḡarbiyyati
al-ḡarībāti pos=ADJ,def=INDF,case=NOM,gen=MASC,num=SG ḡarīb
al-ḡaymata pos=N,def=DEF,case=GEN,num=DU al-ḡaymatayni
al-ḡaymatu pos=N,def=INDF,case=GEN,num=SG ḡaymatin
ʾalḡaytunna pos=V,mood=IND,gen=MASC,per=3,voice=PASS,num=DU,aspect=IPFV yulḡayā
al-ḡayūrayni pos=ADJ,def=INDF,case=ACC,gen=MASC,num=PL ḡuyuran
al-ḡazāl pos=N,poss=PSSD,case=GEN,num=PL ḡizlāni
al-ḡilāfu pos=N,poss=PSSD,case=NOM,num=DU ḡilāfay
al-ḡilmati pos=N,def=DEF,case=NOM,num=DU al-ḡulāmayn
ʾalḡi pos=V,mood=SBJV,gen=MASC,per=3,voice=PASS,num=PL yulḡaw
al-ḡiṭāʾ pos=N,def=DEF,case=GEN,num=PL al-ʾaḡṭiyati
al-ḡiṭāʾu pos=N,def=INDF,case=GEN,num=SG ḡiṭāʾin
al-ḡudrānu pos=N,def=INDF,case=GEN,num=SG ḡadīrin
al-ḡulāmayni pos=N,poss=PSSD,case=ACC,num=PL ḡilmata
al-ḥabību pos=N,def=DEF,case=ACC,num=SG al-ḥabība
al-ḥabs pos=N,poss=PSSD,case=GEN,num=SG ḥabsi
al-ḥadaṯāni pos=N,def=INDF,case=NOM,num=DU ḥadaṯayn
al-ḥadaṯayn pos=N,def=INDF,case=GEN,num=PL ḥudṯānin
al-ḥadaṯ pos=N,poss=PSSD,case=GEN,num=SG ḥadaṯi
al-ḥaddu pos=N,poss=PSSD,case=GEN,num=SG ḥaddi
al-ḥādiṯatayni pos=N,def=DEF,case=NOM,num=PL al-ḥawādiṯu
al-ḥādiṯatayn pos=N,def=INDF,case=NOM,num=SG ḥādiṯatun
al-ḥāfira pos=N,def=INDF,case=GEN,num=SG ḥāfirin
al-ḥaflatayni pos=N,def=INDF,case=NOM,num=SG ḥafla
al-ḥaflatayni pos=N,def=INDF,case=NOM,num=DU ḥaflatāni
al-ḥāʾilātu pos=ADJ,def=INDF,case=NOM,gen=FEM,num=DU ḥāʾilatayn
al-ḥāʾilu pos=N,def=DEF,case=NOM,num=DU al-ḥāʾilāni
al-ḥāʾiṭi pos=N,def=DEF,case=NOM,num=DU al-ḥāʾiṭāni
al-ḥāja pos=N,def=INDF,case=ACC,num=SG ḥājatan
al-ḥājibati pos=ADJ,def=DEF,case=ACC,gen=FEM,num=PL al-ḥājibāti
al-ḥajju pos=N,def=INDF,case=NOM,num=SG ḥajj
al-ḥajju pos=N,poss=PSSD,case=GEN,num=DU ḥajjay
al-ḥākimatāni pos=ADJ,def=INDF,case=NOM,gen=MASC,num=SG ḥākim
al-ḥākimatayn pos=ADJ,def=DEF,case=NOM,gen=FEM,num=SG al-ḥākima
al-ḥākimatayn pos=ADJ,def=DEF,case=NOM,gen=FEM,num=PL al-ḥākimātu
al-ḥakīmāt pos=ADJ,def=DEF,case=NOM,gen=MASC,num=DU al-ḥakīmāni
al-ḥākimatu pos=ADJ,def=INDF,case=ACC,gen=MASC,num=DU ḥākimayni
al-ḥākimayn pos=ADJ,def=INDF,case=ACC,gen=MASC,num=SG ḥākiman
al-ḥākim pos=ADJ,def=DEF,case=NOM,gen=FEM,num=SG al-ḥākimatu
al-ḥalālata pos=ADJ,def=INDF,case=GEN,gen=FEM,num=PL ḥalālātin
al-ḥalālīfa pos=N,def=INDF,case=ACC,num=PL ḥalālīfa
al-ḥalāli pos=ADJ,def=INDF,case=NOM,gen=FEM,num=SG ḥalāla
al-ḥalāl pos=ADJ,def=DEF,case=ACC,gen=MASC,num=SG al-ḥalāla
al-ḥālimayni pos=N,def=DEF,case=NOM,num=PL al-ḥālimīn
al-ḥālimīn pos=N,def=DEF,case=NOM,num=PL al-ḥālimūna
al-ḥallāqīna pos=N,poss=PSSD,case=GEN,num=PL ḥallāqī
al-ḥallāqīn pos=N,def=DEF,case=NOM,num=SG al-ḥallāqu
al-ḥallāq pos=N,poss=PSSD,case=ACC,num=SG ḥallāqa
al-ḥalqata pos=N,def=INDF,case=ACC,num=SG ḥalqatan
al-ḥalqata pos=N,poss=PSSD,case=GEN,num=DU ḥalqatay
al-ḥalqatayn pos=N,def=INDF,case=NOM,num=PL ḥalaqātun
al-ḥalqati pos=N,def=INDF,case=NOM,num=SG ḥalqa
al-ḥāmidatāni pos=ADJ,def=INDF,case=GEN,gen=FEM,num=SG ḥāmidatin
al-ḥamīru pos=N,poss=PSSD,case=GEN,num=PL ḥamīri
al-ḥammārayni pos=N,def=DEF,case=NOM,num=SG al-ḥammār
ʾalhamta pos=V,mood=IND,gen=FEM,per=3,voice=ACT,num=PL,aspect=IPFV yulhimna
ʾalhamū pos=V,mood=IND,gen=MASC,per=3,voice=PASS,num=SG,aspect=IPFV yulham
al-hamzatayni pos=N,def=INDF,case=ACC,num=PL hamzātin
al-hamzāti pos=N,poss=PSSD,case=NOM,num=SG hamzatu
al-hamzatu pos=N,poss=PSSD,case=ACC,num=DU hamzatay
al-ḥanaki pos=N,def=DEF,case=ACC,num=PL al-ʾaḥnāka
al-ḥaqāʾiqi pos=N,def=INDF,case=NOM,num=SG ḥaqīqa
al-ḥaqīqatāni pos=N,poss=PSSD,case=NOM,num=SG ḥaqīqat
al-ḥaqīqiyyatāni pos=ADJ,def=DEF,case=NOM,gen=FEM,num=SG al-ḥaqīqiyyatu
ʾalḥaqti pos=V,mood=SBJV,gen=MASC,per=3,voice=ACT,num=PL yulḥiqū
ʾalḥaqtumā pos=V,mood=SBJV,gen=MASC,per=3,voice=PASS,num=PL yulḥaqū
ʾalḥaqtum pos=V,mood=IND,tense=PRS,gen=MASC,per=2,voice=PASS,num=DU,aspect=IPFV tulḥaqāni
al-ḥarakatu pos=N,poss=PSSD,case=NOM,num=SG ḥarakat
al-ḥarakatu pos=N,poss=PSSD,case=NOM,num=PL ḥarakātu
al-ḥāra pos=N,poss=PSSD,case=GEN,num=SG ḥārati
al-ḥāratu pos=N,poss=PSSD,case=NOM,num=DU ḥāratā
al-ḥarīfayn pos=N,poss=PSSD,case=GEN,num=DU ḥarīfay
al-ḥārra pos=ADJ,def=INDF,case=ACC,gen=FEM,num=DU ḥārratayni
al-ḥārrātu pos=ADJ,def=DEF,case=ACC,gen=FEM,num=PL al-ḥārrāti
al-ḥārrayni pos=ADJ,def=INDF,case=NOM,gen=FEM,num=PL ḥārrāt
al-ḥārrayn pos=ADJ,def=DEF,case=ACC,gen=MASC,num=DU al-ḥārrayni
al-ḥasanatayni pos=N,def=DEF,case=NOM,num=PL al-ḥasanāt
al-ḥašaratāni pos=N,def=INDF,case=NOM,num=PL ḥašarātun
al-ḥašaratayni pos=N,def=INDF,case=ACC,num=DU ḥašaratayni
al-ḥašarāti pos=N,def=DEF,case=ACC,num=SG al-ḥašarata
al-ḥašaratu pos=N,def=DEF,case=NOM,num=SG al-ḥašara
al-ḥašdāni pos=N,poss=PSSD,case=ACC,num=DU ḥašday
al-ḥassāsatayni pos=ADJ,def=DEF,case=NOM,gen=MASC,num=DU al-ḥassāsāni
al-ḥassāsatu pos=ADJ,def=INDF,case=GEN,gen=FEM,num=PL ḥassāsātin
al-ḥassāsu pos=ADJ,def=DEF,case=ACC,gen=FEM,num=SG al-ḥassāsata
al-ḥāsūbayn pos=N,def=INDF,case=NOM,num=PL ḥawāsību
al-ḥāsūbu pos=N,def=DEF,case=ACC,num=SG al-ḥāsūba
al-hātifayn pos=N,def=DEF,case=NOM,num=SG al-hātifu
al-hātifu pos=N,poss=PSSD,case=ACC,num=DU hātifay
al-hawāʾāni pos=N,poss=PSSD,case=GEN,num=PL ʾahwiyati
al-hawādija pos=N,def=DEF,case=NOM,num=PL al-hawādij
al-ḥawājibi pos=N,poss=PSSD,case=GEN,num=PL ḥawājibi
al-hawātifi pos=N,poss=PSSD,case=NOM,num=PL hawātifu
al-hawdaji pos=N,def=DEF,case=ACC,num=DU al-hawdajayni
al-ḥayāʾi pos=N,def=DEF,case=NOM,num=DU al-ḥayāʾayn
al-hayākil pos=N,poss=PSSD,case=ACC,num=DU haykalay
al-hayʾatu pos=N,poss=PSSD,case=NOM,num=SG hayʾatu
al-ḥayawānāni pos=N,def=INDF,case=GEN,num=DU ḥayawānayni
al-ḥayawānu pos=N,def=DEF,case=ACC,num=PL al-ḥayawānāti
al-haykalayni pos=N,def=INDF,case=GEN,num=DU haykalayni
al-hayūliyyata pos=ADJ,def=DEF,case=ACC,gen=MASC,num=SG al-hayūliyya
al-hayūliyyati pos=ADJ,def=INDF,case=ACC,gen=FEM,num=DU hayūliyyatayni
al-hayūliyyayni pos=ADJ,def=DEF,case=NOM,gen=MASC,num=DU al-hayūliyyayn
al-hayūliyyīna pos=ADJ,def=DEF,case=GEN,gen=FEM,num=DU al-hayūliyyatayni
al-ḥayyāti pos=ADJ,def=DEF,case=NOM,gen=FEM,num=DU al-ḥayyatayn
al-ḥayyi pos=N,def=DEF,case=GEN,num=PL al-ʾaḥyāʾi
al-ḥazīnati pos=ADJ,def=DEF,case=GEN,gen=MASC,num=SG al-ḥazīni
al-ḥazīni pos=ADJ,def=INDF,case=NOM,gen=MASC,num=DU ḥazīnayn
al-ḥaẓẓ pos=N,poss=PSSD,case=NOM,num=SG ḥaẓẓu
al-ḥiḏāʾayn pos=N,def=DEF,case=NOM,num=DU al-ḥiḏāʾāni
al-ḥiḏāʾ pos=N,poss=PSSD,case=ACC,num=PL ʾaḥḏiyata
al-ḥiḍnayni pos=N,def=INDF,case=NOM,num=DU ḥiḍnayn
al-ḥiḍni pos=N,def=INDF,case=ACC,num=PL ʾaḥḍānan
al-ḥikāyātu pos=N,def=INDF,case=NOM,num=PL ḥikāyātun
al-hilāla pos=N,def=DEF,case=NOM,num=DU al-hilālayn
al-hilālayn pos=N,poss=PSSD,case=ACC,num=SG hilāla
al-hindī pos=ADJ,def=DEF,case=GEN,gen=MASC,num=PL al-hindiyyīna
al-ḥiqfa pos=N,poss=PSSD,case=NOM,num=SG ḥiqfu
ʾalḥiq pos=V,mood=IND,tense=PST,gen=MASC,per=3,voice=ACT,num=DU,aspect=IPFV ʾalḥaqā
al-ḥirrīfatu pos=ADJ,def=DEF,case=GEN,gen=FEM,num=DU al-ḥirrīfatayni
al-ḥizbayni pos=N,poss=PSSD,case=NOM,num=PL ʾaḥzāb
al-ḥudṯānu pos=N,def=DEF,case=NOM,num=PL al-ḥudṯān
al-ḥulwa pos=ADJ,def=DEF,case=GEN,gen=MASC,num=SG al-ḥulwi
al-ḥulwati pos=ADJ,def=INDF,case=NOM,gen=MASC,num=SG ḥulwun
al-ḥulwāti pos=ADJ,def=INDF,case=NOM,gen=MASC,num=SG ḥulwun
al-ḥulwayni pos=ADJ,def=DEF,case=NOM,gen=FEM,num=PL al-ḥulwāt
al-ḥušūdu pos=N,poss=PSSD,case=NOM,num=PL ḥušūdu
al-ḥūta pos=N,def=INDF,case=GEN,num=DU ḥūtayni
al-ḥuzam pos=N,poss=PSSD,case=NOM,num=SG ḥuzmatu
al-ḥuzmatāni pos=N,poss=PSSD,case=NOM,num=SG ḥuzmat
al-ʾibāḥiyyāni pos=ADJ,def=INDF,case=NOM,gen=FEM,num=DU ʾibāḥiyyatāni
al-ʾibāḥiyyatāni pos=ADJ,def=INDF,case=GEN,gen=MASC,num=DU ʾibāḥiyyayni
al-ʿibāratayni pos=N,def=INDF,case=NOM,num=DU ʿibāratayn
al-ʿibārāt pos=N,def=INDF,case=NOM,num=DU ʿibāratayn
al-ʿibāratu pos=N,poss=PSSD,case=NOM,num=DU ʿibāratay
al-ʾiblīsayni pos=N,def=INDF,case=ACC,num=DU ʾiblīsayni
al-ʾiblīsayn pos=N,poss=PSSD,case=ACC,num=SG ʾiblīsa
al-ʾiblīsi pos=N,poss=PSSD,case=ACC,num=SG ʾiblīsa
al-ʾiblīsiyyata pos=ADJ,def=INDF,case=ACC,gen=MASC,num=PL ʾiblīsiyyīna
al-ʾiblīsiyyatu pos=ADJ,def=DEF,case=NOM,gen=FEM,num=SG al-ʾiblīsiyya
al-ʿibriyyāni pos=ADJ,def=INDF,case=GEN,gen=MASC,num=DU ʿibriyyayni
al-ʾibṭāni pos=N,def=DEF,case=ACC,num=DU al-ʾibṭayni
al-ibtisāmāti pos=N,poss=PSSD,case=GEN,num=SG ibtisāmati
al-ʾiḍāfatayn pos=N,def=DEF,case=NOM,num=PL al-ʾiḍāfātu
al-ʾiḍāfāt pos=N,poss=PSSD,case=GEN,num=SG ʾiḍāfati
ʾalifbāʾiyyāni pos=ADJ,def=DEF,case=GEN,gen=FEM,num=PL al-ʾalifbāʾiyyāti
ʾalifbāʾiyyatayni pos=ADJ,def=DEF,case=GEN,gen=MASC,num=SG al-ʾalifbāʾiyyi
ʾalifbāʾiyyatayn pos=ADJ,def=DEF,case=ACC,gen=MASC,num=PL al-ʾalifbāʾiyyīna
ʾalifbāʾiyyātin pos=ADJ,def=INDF,case=GEN,gen=MASC,num=DU ʾalifbāʾiyyayni
ʾalifbāʾiyyātun pos=ADJ,def=INDF,case=NOM,gen=FEM,num=DU ʾalifbāʾiyyatayn
ʾalifbāʾiyyun pos=ADJ,def=INDF,case=GEN,gen=MASC,num=SG ʾalifbāʾiyyin
al-iftitāḥī pos=ADJ,def=INDF,case=NOM,gen=MASC,num=SG iftitāḥī
al-iftitāḥiyya pos=ADJ,def=INDF,case=NOM,gen=MASC,num=DU iftitāḥiyyāni
al-iftitāḥiyyayni pos=ADJ,def=DEF,case=GEN,gen=MASC,num=SG al-iftitāḥiyyi
al-iḡtiṣābi pos=N,poss=PSSD,case=NOM,num=PL iḡtiṣābātu
al-iḥtilāmu pos=N,def=INDF,case=NOM,num=PL iḥtilāmātun
al-ihtimāmayn pos=N,def=INDF,case=NOM,num=PL ihtimāmāt
al-ʾījābiyyāti pos=ADJ,def=DEF,case=GEN,gen=FEM,num=PL al-ʾījābiyyāti
al-ʾijāza pos=N,def=INDF,case=NOM,num=PL ʾijāzāt
al-ijtimāʿiyyayn pos=ADJ,def=DEF,case=GEN,gen=FEM,num=SG al-ijtimāʿiyyati
al-iktišāfāni pos=N,def=DEF,case=GEN,num=DU al-iktišāfayni
al-iktišāfāni pos=N,def=INDF,case=NOM,num=SG iktišāf
al-iktišāfāti pos=N,poss=PSSD,case=NOM,num=PL iktišāfāt
al-iḵtiyāri pos=N,poss=PSSD,case=ACC,num=PL iḵtiyārāti
al-iḵtiyāri pos=N,poss=PSSD,case=NOM,num=DU iḵtiyārā
al-ʾiliktrūni pos=N,def=INDF,case=GEN,num=SG ʾiliktrūnin
al-ʾiliktrūniyya pos=ADJ,def=DEF,case=NOM,gen=MASC,num=PL al-ʾiliktrūniyyīn
al-ʾiliktrūniyyayn pos=ADJ,def=INDF,case=NOM,gen=FEM,num=DU ʾiliktrūniyyatayn
al-ʿilmāniyya pos=ADJ,def=DEF,case=NOM,gen=FEM,num=PL al-ʿilmāniyyāt
al-ʿilmāniyyatāni pos=ADJ,def=DEF,case=GEN,gen=FEM,num=DU al-ʿilmāniyyatayni
al-ʿilmāniyyayni pos=ADJ,def=INDF,case=ACC,gen=MASC,num=PL ʿilmāniyyīna
al-ʿilmāniyyīna pos=ADJ,def=INDF,case=NOM,gen=FEM,num=SG ʿilmāniyyatun
al-ʿilmiyyata pos=ADJ,def=INDF,case=NOM,gen=FEM,num=PL ʿilmiyyātun
al-ʿilmiyyatayni pos=ADJ,def=INDF,case=NOM,gen=FEM,num=PL ʿilmiyyāt
al-ʿilmiyyu pos=ADJ,def=INDF,case=GEN,gen=MASC,num=PL ʿilmiyyīna
al-ʾimāmayn pos=N,def=INDF,case=NOM,num=PL ʾaʾimma
al-ʾimāmu pos=N,def=DEF,case=GEN,num=DU al-ʾimāmayni
ʾālimā pos=V,mood=IND,tense=PST,gen=FEM,per=2,voice=ACT,num=SG,aspect=IPFV ʾālamti
al-ʾimārātiyyayni pos=ADJ,def=DEF,case=NOM,gen=MASC,num=SG al-ʾimārātī
al-ʾimārātiyyayn pos=ADJ,def=INDF,case=NOM,gen=FEM,num=PL ʾimārātiyyātun
ʿalīmāt pos=ADJ,def=INDF,case=NOM,gen=FEM,num=PL ʿalīmātun
ʿalīmātun pos=ADJ,def=INDF,case=GEN,gen=MASC,num=DU ʿalīmayni
ʿalīmayn pos=ADJ,def=INDF,case=ACC,gen=MASC,num=SG ʿalīman
al-ʿimlāqāni pos=ADJ,def=DEF,case=NOM,gen=MASC,num=DU al-ʿimlāqayn
al-ʿimlāqiyyatayni pos=ADJ,def=DEF,case=NOM,gen=FEM,num=DU al-ʿimlāqiyyatāni
al-ʿimlāqiyyatu pos=ADJ,def=INDF,case=NOM,gen=FEM,num=SG ʿimlāqiyyatun
al-ʾimmarayn pos=ADJ,def=INDF,case=GEN,gen=MASC,num=SG ʾimmarin
al-imtiḥānayni pos=N,poss=PSSD,case=GEN,num=PL imtiḥānāti
al-imtiḥāni pos=N,def=DEF,case=ACC,num=DU al-imtiḥānayni
ʾālimū pos=V,mood=IND,tense=PST,gen=MASC,per=3,voice=PASS,num=DU,aspect=IPFV ʾūlimā
ʾaʿlinā pos=V,mood=IND,tense=PST,gen=FEM,per=1,voice=PASS,num=SG,aspect=IPFV ʾuʿlintu
al-ʾindūnīsiyyatāni pos=ADJ,def=DEF,case=NOM,gen=MASC,num=PL al-ʾindūnīsiyyūna
al-ʾindūnīsiyyati pos=ADJ,def=INDF,case=NOM,gen=FEM,num=DU ʾindūnīsiyyatayn
al-ʾindūnīsiyyāt pos=ADJ,def=INDF,case=GEN,gen=MASC,num=SG ʾindūnīsiyyin
al-ʾindūnīsiyyatu pos=ADJ,def=DEF,case=GEN,gen=MASC,num=DU al-ʾindūnīsiyyayni
al-ʾingilīziyyati pos=ADJ,def=INDF,case=ACC,gen=MASC,num=SG ʾingilīziyyan
al-ʾingilīziyyātu pos=ADJ,def=INDF,case=ACC,gen=FEM,num=PL ʾingilīziyyātin
al-ʾingilīziyyayn pos=ADJ,def=DEF,case=NOM,gen=MASC,num=DU al-ʾingilīziyyāni
al-ʾingilīziyyu pos=ADJ,def=DEF,case=ACC,gen=FEM,num=PL al-ʾingilīziyyāti
al-ʾinkilīziyyatayn pos=ADJ,def=INDF,case=GEN,gen=MASC,num=SG ʾinkilīziyyin
al-ʾinkilīziyyātu pos=ADJ,def=DEF,case=ACC,gen=FEM,num=SG al-ʾinkilīziyyata
al-ʾinkilīziyyatu pos=ADJ,def=DEF,case=GEN,gen=FEM,num=SG al-ʾinkilīziyyati
al-ʾinkilīziyyayn pos=ADJ,def=INDF,case=GEN,gen=MASC,num=PL ʾinkilīziyyīna
al-ʾinkilīziyyu pos=ADJ,def=DEF,case=NOM,gen=MASC,num=PL al-ʾinkilīziyyīn
ʿālin pos=V,mood=IND,gen=FEM,per=1,voice=ACT,num=PL,aspect=IPFV naʿli
al-intiḵābāni pos=N,def=DEF,case=NOM,num=PL al-intiḵābātu
al-intiṣārāni pos=N,def=INDF,case=GEN,num=SG intiṣārin
al-intiṣāra pos=N,def=INDF,case=NOM,num=DU intiṣārayn
ʾaʿlinū pos=V,mood=IMP,gen=FEM,per=2,voice=ACT,num=PL ʾaʿlinna
al-ʾīqāʿāti pos=N,poss=PSSD,case=NOM,num=SG ʾīqāʿ
al-ʾīqāʿātu pos=N,def=INDF,case=GEN,num=SG ʾīqāʿin
al-ʾiqlīmāni pos=N,def=INDF,case=NOM,num=SG ʾiqlīm
al-ʾirāda pos=N,poss=PSSD,case=NOM,num=DU ʾirādatā
al-ʾirādatayn pos=N,poss=PSSD,case=GEN,num=DU ʾirādatay
al-ʾirādati pos=N,def=INDF,case=ACC,num=PL ʾirādātin
al-ʾīrānī pos=ADJ,def=DEF,case=NOM,gen=FEM,num=PL al-ʾīrāniyyāt
al-ʾīrāniyya pos=ADJ,def=DEF,case=NOM,gen=FEM,num=SG al-ʾīrāniyya
al-ʾīrāniyyata pos=ADJ,def=INDF,case=NOM,gen=MASC,num=DU ʾīrāniyyāni
al-ʾīrāniyyūna pos=ADJ,def=DEF,case=NOM,gen=MASC,num=DU al-ʾīrāniyyayn
al-ʿirāqī pos=ADJ,def=DEF,case=ACC,gen=MASC,num=SG al-ʿirāqiyya
al-ʿirāqiyyāni pos=ADJ,def=DEF,case=NOM,gen=MASC,num=DU al-ʿirāqiyyayn
al-ʿirāqiyya pos=ADJ,def=DEF,case=NOM,gen=MASC,num=PL al-ʿirāqiyyūna
al-ʿirāqiyyata pos=ADJ,def=DEF,case=ACC,gen=MASC,num=DU al-ʿirāqiyyayni
al-ʿirāqiyyatayn pos=ADJ,def=DEF,case=ACC,gen=FEM,num=PL al-ʿirāqiyyāti
al-ʾirhābiyyata pos=ADJ,def=DEF,case=ACC,gen=FEM,num=DU al-ʾirhābiyyatayni
al-ʾiṣābati pos=N,def=INDF,case=NOM,num=PL ʾiṣābātun
al-ʾiṣābati pos=N,poss=PSSD,case=NOM,num=PL ʾiṣābāt
al-ʾiʿṣārāni pos=N,poss=PSSD,case=NOM,num=DU ʾiʿṣāray
al-ʾišāratāni pos=N,def=INDF,case=NOM,num=PL ʾišārātun
al-ʾiʿṣāru pos=N,def=INDF,case=ACC,num=DU ʾiʿṣārayni
al-ʾiṣbaʿa pos=N,def=DEF,case=GEN,num=PL al-ʾaṣābiʿi
al-ʾislāmī pos=ADJ,def=INDF,case=NOM,gen=FEM,num=SG ʾislāmiyya
al-ʾisrāʾīliyyāti pos=ADJ,def=DEF,case=ACC,gen=MASC,num=PL al-ʾisrāʾīliyyīna
al-ʾisrāʾīliyyati pos=ADJ,def=INDF,case=GEN,gen=MASC,num=SG ʾisrāʾīliyyin
al-ʾisrāʾīliyyayni pos=ADJ,def=DEF,case=NOM,gen=FEM,num=PL al-ʾisrāʾīliyyātu
al-ʾisrāʾīliyyi pos=ADJ,def=INDF,case=NOM,gen=MASC,num=SG ʾisrāʾīlī
al-ʾisrāʾīliyyūna pos=ADJ,def=INDF,case=ACC,gen=FEM,num=SG ʾisrāʾīliyyatan
al-istiḵdāmāni pos=N,def=INDF,case=NOM,num=SG istiḵdām
al-istiḵdāma pos=N,def=DEF,case=ACC,num=DU al-istiḵdāmayni
al-istiʿmāli pos=N,poss=PSSD,case=NOM,num=SG istiʿmālu
al-istiqbālāt pos=N,def=INDF,case=NOM,num=PL istiqbālātun
al-ʾīṭāliyyatayn pos=ADJ,def=INDF,case=ACC,gen=FEM,num=SG ʾīṭāliyyatan
al-ʾīṭāliyyatayn pos=ADJ,def=INDF,case=NOM,gen=MASC,num=PL ʾīṭāliyyīn
al-ʾīṭāliyyu pos=ADJ,def=INDF,case=NOM,gen=FEM,num=SG ʾīṭāliyyatun
al-iʿtiqādi pos=N,def=INDF,case=NOM,num=PL iʿtiqādāt
al-iʿtiqād pos=N,def=DEF,case=GEN,num=SG al-iʿtiqādi
al-ittifāqāt pos=N,def=INDF,case=ACC,num=DU ittifāqayni
al-ittifāqayni pos=N,def=INDF,case=NOM,num=DU ittifāqayn
al-ittifāqayn pos=N,def=INDF,case=ACC,num=PL ittifāqātin
al-ittiḥādāti pos=N,def=DEF,case=NOM,num=SG al-ittiḥād
al-ittiḥādayn pos=N,poss=PSSD,case=NOM,num=DU ittiḥādā
al-jaḏḏābatayn pos=ADJ,def=INDF,case=NOM,gen=MASC,num=DU jaḏḏābayn
al-jaḏḏābayn pos=ADJ,def=INDF,case=GEN,gen=FEM,num=SG jaḏḏābatin
al-jāḏibatāni pos=ADJ,def=INDF,case=GEN,gen=MASC,num=PL jawāḏiba
al-jāḏibātu pos=ADJ,def=DEF,case=NOM,gen=FEM,num=SG al-jāḏiba
al-jadīdata pos=ADJ,def=DEF,case=NOM,gen=FEM,num=DU al-jadīdatāni
al-jadīdati pos=ADJ,def=DEF,case=GEN,gen=MASC,num=DU al-jadīdayni
al-jāffati pos=ADJ,def=DEF,case=ACC,gen=FEM,num=SG al-jāffata
al-jāffati pos=ADJ,def=INDF,case=GEN,gen=FEM,num=SG jāffatin
al-jāhilāni pos=ADJ,def=DEF,case=ACC,gen=FEM,num=PL al-jāhilāti
al-jāhilatāni pos=ADJ,def=INDF,case=ACC,gen=FEM,num=PL jāhilātin
al-jāhilāti pos=ADJ,def=INDF,case=ACC,gen=FEM,num=DU jāhilatayni
al-jāhiliyyayn pos=ADJ,def=DEF,case=ACC,gen=FEM,num=DU al-jāhiliyyatayni
al-jāʾiza pos=N,def=INDF,case=GEN,num=PL jawāʾiza
al-jakētātu pos=N,poss=PSSD,case=ACC,num=DU jakētay
al-jakētu pos=N,def=DEF,case=ACC,num=PL al-jakētāti
al-jamārik pos=N,poss=PSSD,case=GEN,num=SG jumruki
al-jāmiʿatāni pos=N,poss=PSSD,case=NOM,num=SG jāmiʿatu
al-jāmiʿatayni pos=N,def=INDF,case=ACC,num=PL jāmiʿātin
al-jāmiʿāti pos=N,poss=PSSD,case=NOM,num=PL jāmiʿātu
al-jamīlatayn pos=ADJ,def=INDF,case=NOM,gen=FEM,num=PL jamīlāt
al-jāniba pos=N,def=INDF,case=NOM,num=PL jawānibu
al-jānib pos=N,def=DEF,case=NOM,num=DU al-jānibayn
al-jannati pos=N,def=DEF,case=NOM,num=DU al-jannatayn
al-janūbiyyati pos=ADJ,def=INDF,case=NOM,gen=MASC,num=SG janūbiyyun
al-janūbiyyayni pos=ADJ,def=DEF,case=GEN,gen=FEM,num=SG al-janūbiyyati
al-janūbiyyayn pos=ADJ,def=DEF,case=NOM,gen=MASC,num=SG al-janūbī
al-janūbiyyīn pos=ADJ,def=INDF,case=NOM,gen=FEM,num=SG janūbiyyatun
al-janūbiyyūna pos=ADJ,def=DEF,case=NOM,gen=FEM,num=SG al-janūbiyyatu
al-jaras pos=N,poss=PSSD,case=ACC,num=PL ʾajrāsa
al-jarru pos=N,def=INDF,case=NOM,num=DU jarrayn
al-jasadu pos=N,poss=PSSD,case=NOM,num=DU jasaday
al-jasīmāni pos=ADJ,def=INDF,case=NOM,gen=FEM,num=DU jasīmatayn
al-jasīmatāni pos=ADJ,def=INDF,case=NOM,gen=FEM,num=PL jasīmāt
al-jasīmi pos=ADJ,def=DEF,case=NOM,gen=FEM,num=DU al-jasīmatāni
al-jawāba pos=N,def=DEF,case=NOM,num=PL al-ajwiba
al-jawābi pos=N,poss=PSSD,case=ACC,num=SG jawāba
al-jawādāti pos=ADJ,def=INDF,case=ACC,gen=MASC,num=SG jawādan
al-jawāmīsi pos=N,poss=PSSD,case=GEN,num=DU jāmūsay
al-jawāniba pos=N,def=INDF,case=ACC,num=DU jānibayni
al-jawwiyyati pos=ADJ,def=DEF,case=ACC,gen=FEM,num=DU al-jawwiyyatayni
al-jawwiyyatu pos=ADJ,def=INDF,case=NOM,gen=MASC,num=DU jawwiyyāni
al-jawwiyyu pos=ADJ,def=DEF,case=NOM,gen=MASC,num=DU al-jawwiyyāni
al-jaybāni pos=N,poss=PSSD,case=ACC,num=SG jayba
al-jaybayn pos=N,poss=PSSD,case=NOM,num=SG jaybu
al-jazāʾiriyyatayni pos=ADJ,def=DEF,case=NOM,gen=FEM,num=PL al-jazāʾiriyyātu
al-jazāʾiriyyāt pos=ADJ,def=INDF,case=GEN,gen=MASC,num=DU jazāʾiriyyayni
al-jazāʾiriyyayn pos=ADJ,def=INDF,case=ACC,gen=MASC,num=PL jazāʾiriyyīna
al-jazāʾiriyyu pos=ADJ,def=DEF,case=ACC,gen=FEM,num=SG al-jazāʾiriyyata
al-jidārayn pos=N,poss=PSSD,case=ACC,num=SG jidāra
al-jidāru pos=N,def=INDF,case=NOM,num=SG jidār
al-jihādiyyatu pos=ADJ,def=DEF,case=NOM,gen=FEM,num=DU al-jihādiyyatayn
al-jihādiyyīna pos=ADJ,def=INDF,case=GEN,gen=FEM,num=SG jihādiyyatin
al-jihāt pos=N,def=INDF,case=ACC,num=DU jihatayni
al-jild pos=N,def=INDF,case=NOM,num=DU jildāni
al-jimāla pos=ADJ,def=DEF,case=ACC,gen=FEM,num=PL al-jamīlāti
al-jinsiyya pos=ADJ,def=INDF,case=NOM,gen=MASC,num=DU jinsiyyayn
al-jinsiyyu pos=ADJ,def=DEF,case=GEN,gen=MASC,num=DU al-jinsiyyayni
al-jirāru pos=N,poss=PSSD,case=ACC,num=DU jarray
al-jismi pos=N,def=INDF,case=GEN,num=PL jusūmin
al-jism pos=N,def=INDF,case=NOM,num=SG jismun
al-jiwāʾu pos=N,def=INDF,case=NOM,num=DU jawwāni
al-juḥūra pos=N,def=INDF,case=NOM,num=DU juḥrayn
al-jūḵi pos=N,def=DEF,case=ACC,num=DU al-jūḵayni
al-jūḵ pos=N,poss=PSSD,case=GEN,num=PL ʾajwāḵi
al-julūda pos=N,poss=PSSD,case=NOM,num=SG jildu
al-jumal pos=N,def=DEF,case=NOM,num=DU al-jumlatayn
al-jumhūrāni pos=N,def=DEF,case=ACC,num=PL al-jamāhīra
al-jumlatayn pos=N,def=INDF,case=GEN,num=SG jumlatin
al-junūdu pos=N,def=DEF,case=GEN,num=DU al-jundiyyayni
al-jusaymātu pos=N,poss=PSSD,case=NOM,num=DU jusaymā
al-jusaymayn pos=N,def=DEF,case=NOM,num=PL al-jusaymātu
al-jusaymu pos=N,def=INDF,case=ACC,num=SG jusayman
al-jusūmi pos=N,poss=PSSD,case=NOM,num=SG jism
al-juṯṯatu pos=N,poss=PSSD,case=ACC,num=PL ʾajṯāṯa
al-juyūba pos=N,poss=PSSD,case=NOM,num=PL juyūbu
al-juzʾa pos=N,def=DEF,case=ACC,num=DU al-juzʾayni
al-juzayʾiyyayni pos=ADJ,def=INDF,case=ACC,gen=MASC,num=DU juzayʾiyyayni
al-juzayʾiyyūna pos=ADJ,def=DEF,case=GEN,gen=MASC,num=SG al-juzayʾiyyi
al-juzʾayni pos=N,poss=PSSD,case=GEN,num=DU juzʾay
al-juzayʾ pos=N,def=DEF,case=NOM,num=PL al-juzayʾāt
al-kaʿbata pos=N,def=DEF,case=ACC,num=DU al-kaʿbatayni
al-kaʿbati pos=N,def=DEF,case=NOM,num=DU al-kaʿbatayn
al-kābūsayn pos=N,def=DEF,case=NOM,num=PL al-kawābīsu
al-ḵaddayn pos=N,poss=PSSD,case=NOM,num=DU ḵaddā
al-ḵaḍrāʾ pos=ADJ,def=DEF,case=NOM,gen=MASC,num=DU al-ʾaḵḍarāni
al-ḵaḍrāʾu pos=ADJ,def=DEF,case=NOM,gen=MASC,num=PL al-ḵuḍr
al-kafāʾatayn pos=N,poss=PSSD,case=GEN,num=PL kafāʾāti
al-kafāʾātu pos=N,poss=PSSD,case=NOM,num=SG kafāʾat
al-kaffa pos=N,def=DEF,case=ACC,num=DU al-kaffayni
al-kaffayni pos=N,def=INDF,case=GEN,num=DU kaffayni
al-ḵafīfāti pos=ADJ,def=INDF,case=NOM,gen=FEM,num=DU ḵafīfatāni
al-kahanati pos=N,def=INDF,case=ACC,num=SG kāhinan
al-kahrabāni pos=N,def=DEF,case=NOM,num=SG al-kahrabu
al-ḵāʾifātu pos=ADJ,def=INDF,case=GEN,gen=FEM,num=SG ḵāʾifatin
al-kalak pos=N,poss=PSSD,case=NOM,num=DU kalakā
al-ḵalīj pos=N,def=INDF,case=ACC,num=DU ḵalījayni
al-ḵalīj pos=N,def=INDF,case=ACC,num=SG ḵalījan
al-ḵallāqata pos=ADJ,def=DEF,case=NOM,gen=FEM,num=DU al-ḵallāqatāni
al-ḵallāqatayn pos=ADJ,def=INDF,case=GEN,gen=FEM,num=PL ḵallāqātin
al-ḵallāqatu pos=ADJ,def=DEF,case=NOM,gen=FEM,num=DU al-ḵallāqatāni
al-ḵallu pos=N,def=INDF,case=NOM,num=SG ḵall
al-ḵallu pos=N,poss=PSSD,case=NOM,num=PL ḵilālu
al-kamālāni pos=N,def=INDF,case=NOM,num=PL kamālātun
al-kāmēra pos=N,def=INDF,case=NOM,num=PL kāmērāt
al-ḵāmisa pos=ADJ,def=INDF,case=NOM,gen=FEM,num=SG ḵāmisatun
al-ḵāmisata pos=ADJ,def=DEF,case=NOM,gen=MASC,num=SG al-ḵāmis
al-kammiyyatayni pos=N,def=DEF,case=NOM,num=DU al-kammiyyatāni
al-kamratayn pos=N,def=INDF,case=GEN,num=DU kamratayni
al-ḵanādiq pos=N,poss=PSSD,case=GEN,num=DU ḵandaqay
al-ḵanāfisi pos=N,def=INDF,case=GEN,num=SG ḵunfusāʾin
al-ḵanāfisu pos=N,def=DEF,case=NOM,num=SG al-ḵunfusāʾu
al-ḵanāzīri pos=N,def=INDF,case=NOM,num=DU ḵinzīrāni
al-ḵandaqa pos=N,poss=PSSD,case=GEN,num=PL ḵanādiqi
al-karb pos=N,poss=PSSD,case=ACC,num=PL kurūba
al-karīmatu pos=ADJ,def=INDF,case=GEN,gen=FEM,num=DU karīmatayni
al-kāriṯatāni pos=N,def=INDF,case=NOM,num=SG kāriṯa
al-kāriṯata pos=N,poss=PSSD,case=ACC,num=SG kāriṯata
al-kāriṯatayn pos=N,poss=PSSD,case=ACC,num=PL kawāriṯa
al-kaʾsa pos=N,def=DEF,case=GEN,num=DU al-kaʾsayni
al-kaʾsayni pos=N,def=DEF,case=NOM,num=SG al-kaʾsu
al-ḵaṣībatāni pos=ADJ,def=DEF,case=NOM,gen=FEM,num=SG al-ḵaṣība
al-ḵaṣībatu pos=ADJ,def=DEF,case=GEN,gen=FEM,num=SG al-ḵaṣībati
al-ḵaṣībayni pos=ADJ,def=DEF,case=NOM,gen=FEM,num=SG al-ḵaṣībatu
al-ḵāṣṣa pos=N,poss=PSSD,case=GEN,num=PL ḵawāṣṣi
al-ḵāṣṣatāni pos=N,def=INDF,case=ACC,num=SG ḵāṣṣatan
al-kātibāni pos=N,def=DEF,case=GEN,num=PL al-katabati
al-kātibayn pos=N,def=INDF,case=NOM,num=PL kataba
al-kāṯūlīkiyyāt pos=ADJ,def=DEF,case=NOM,gen=FEM,num=SG al-kāṯūlīkiyya
al-ḵaṭwa pos=N,poss=PSSD,case=GEN,num=PL ḵiṭāʾi
al-ḵaʾūnati pos=ADJ,def=INDF,case=NOM,gen=FEM,num=SG ḵaʾūnatun
al-ḵaʾūnayni pos=ADJ,def=DEF,case=ACC,gen=MASC,num=SG al-ḵaʾūna
al-kawābīs pos=N,def=INDF,case=NOM,num=DU kābūsāni
al-ḵawanata pos=N,def=INDF,case=NOM,num=SG ḵāʾin
al-ḵawanati pos=N,poss=PSSD,case=NOM,num=PL ḵawanat
al-ḵawanatu pos=N,def=DEF,case=NOM,num=PL al-ḵawana
al-kawniyyati pos=ADJ,def=DEF,case=ACC,gen=MASC,num=PL al-kawniyyīna
al-kawniyyayn pos=ADJ,def=DEF,case=GEN,gen=MASC,num=SG al-kawniyyi
al-kawniyyayn pos=ADJ,def=INDF,case=NOM,gen=MASC,num=PL kawniyyīn
al-ḵaymatāni pos=N,def=INDF,case=NOM,num=DU ḵaymatayn
al-ḵaymatayni pos=N,poss=PSSD,case=NOM,num=DU ḵaymatā
al-ḵayyāṭa pos=N,def=INDF,case=NOM,num=SG ḵayyāṭ
al-ḵayyāṭīna pos=N,poss=PSSD,case=ACC,num=SG ḵayyāṭa
al-ḵīfa pos=N,poss=PSSD,case=ACC,num=DU ḵīfatay
al-ḵīfati pos=N,poss=PSSD,case=GEN,num=PL ḵīfi
al-ḵīf pos=N,def=INDF,case=ACC,num=DU ḵīfatayni
al-ḵilāli pos=N,def=DEF,case=NOM,num=PL al-ḵilāl
al-ḵilāl pos=N,poss=PSSD,case=NOM,num=PL ḵilālu
al-kīlomitrātu pos=N,def=DEF,case=NOM,num=PL al-kīlomitrāt
al-kīlomitrayni pos=N,def=DEF,case=NOM,num=PL al-kīlomitrāt
al-kīlomitrayn pos=N,poss=PSSD,case=GEN,num=PL kīlomitrāti
al-ḵirfānu pos=N,poss=PSSD,case=ACC,num=PL ḵirfāna
al-kisāʾi pos=N,def=INDF,case=GEN,num=PL ʾaksiyatin
al-ḵiyami pos=N,def=DEF,case=NOM,num=DU al-ḵaymatayn
al-kiyasata pos=N,def=INDF,case=ACC,num=DU kīsayni
al-ḵizānatāni pos=N,def=DEF,case=GEN,num=DU al-ḵizānatayni
al-ḵizānatāni pos=N,poss=PSSD,case=NOM,num=SG ḵizānat
al-kubbāya pos=N,def=INDF,case=NOM,num=SG kubbāya
al-kubbāyatayn pos=N,poss=PSSD,case=GEN,num=SG kubbāyati
al-kubbāyāti pos=N,poss=PSSD,case=ACC,num=DU kubbāyatay
al-kūbu pos=N,def=DEF,case=GEN,num=SG al-kūbi
al-ḵuḍaru pos=N,def=INDF,case=ACC,num=SG ḵuḍratan
al-ḵuḍr pos=ADJ,def=INDF,case=NOM,gen=MASC,num=PL ḵuḍr
al-kuḥūliyyīna pos=ADJ,def=DEF,case=GEN,gen=MASC,num=SG al-kuḥūliyyi
al-kuḥūliyyūna pos=ADJ,def=DEF,case=GEN,gen=FEM,num=DU al-kuḥūliyyatayni
al-kuḥūliyyu pos=ADJ,def=DEF,case=NOM,gen=MASC,num=DU al-kuḥūliyyayn
al-ḵurjāni pos=N,poss=PSSD,case=NOM,num=PL ḵirajatu
al-ḵurṭūmāni pos=N,def=DEF,case=NOM,num=SG al-ḵurṭūmu
al-ḵuṣlatayn pos=N,def=DEF,case=NOM,num=PL al-ḵuṣalu
al-ḵuṣūru pos=N,def=INDF,case=NOM,num=DU ḵaṣrāni
al-ḵuṣūṣiyyata pos=ADJ,def=DEF,case=NOM,gen=MASC,num=PL al-ḵuṣūṣiyyīn
al-ḵuṣūṣiyyatayn pos=ADJ,def=DEF,case=NOM,gen=FEM,num=PL al-ḵuṣūṣiyyātu
al-ḵuṣūṣiyyati pos=ADJ,def=INDF,case=ACC,gen=MASC,num=PL ḵuṣūṣiyyīna
al-kuwarku pos=N,def=INDF,case=GEN,num=SG kuwarkin
al-kuwaytiyyāni pos=ADJ,def=INDF,case=NOM,gen=FEM,num=SG kuwaytiyyatun
al-kuwaytiyyu pos=ADJ,def=DEF,case=ACC,gen=MASC,num=PL al-kuwaytiyyīna
al-labanayn pos=N,def=INDF,case=NOM,num=PL libān
al-labani pos=N,def=DEF,case=NOM,num=DU al-labanayn
al-labuʾati pos=N,def=INDF,case=NOM,num=SG labuʾatun
al-labuʾātu pos=N,def=DEF,case=GEN,num=SG al-labuʾati
al-laḏīḏatu pos=ADJ,def=DEF,case=GEN,gen=MASC,num=SG al-laḏīḏi
al-laḏīḏayn pos=ADJ,def=DEF,case=NOM,gen=MASC,num=DU al-laḏīḏāni
al-laḥẓata pos=N,poss=PSSD,case=NOM,num=PL laḥẓātu
al-laḥẓatayni pos=N,def=INDF,case=GEN,num=SG laḥẓatin
al-lāʿibi pos=N,def=INDF,case=NOM,num=DU lāʿibāni
al-lāʾiqatayn pos=ADJ,def=INDF,case=NOM,gen=MASC,num=DU lāʾiqāni
al-lā-nihāya pos=N,poss=PSSD,case=NOM,num=SG lā-nihāyatu
al-lā-nihāyatayn pos=N,def=DEF,case=NOM,num=PL al-lā-nihāyāt
al-lā-nihāyāti pos=N,poss=PSSD,case=NOM,num=SG lā-nihāyatu
al-laqlaqa pos=N,poss=PSSD,case=GEN,num=PL laqāliqi
al-lawlaba pos=N,poss=PSSD,case=NOM,num=SG lawlab
al-libāni pos=N,def=DEF,case=NOM,num=SG al-labanu
al-lībirāliyyatāni pos=ADJ,def=DEF,case=ACC,gen=MASC,num=SG al-lībirāliyya
al-lībirāliyyāti pos=ADJ,def=DEF,case=ACC,gen=FEM,num=SG al-lībirāliyyata
al-lībirāliyyatu pos=ADJ,def=INDF,case=NOM,gen=FEM,num=PL lībirāliyyāt
al-lībiyyayn pos=ADJ,def=INDF,case=NOM,gen=MASC,num=PL lībiyyūna
al-lībiyyīn pos=ADJ,def=INDF,case=GEN,gen=MASC,num=PL lībiyyīna
al-lībiyyūna pos=ADJ,def=DEF,case=GEN,gen=MASC,num=DU al-lībiyyayni
al-lifāfa pos=N,def=INDF,case=GEN,num=SG lifāfatin
al-lifāfati pos=N,def=INDF,case=NOM,num=PL lafāʾifu
ʾallihā pos=V,mood=SBJV,gen=FEM,per=3,voice=ACT,num=DU tuʾallihā
ʾallihū pos=V,mood=IND,gen=MASC,per=2,voice=ACT,num=DU,aspect=IPFV tuʾallihā
al-liqāʾayn pos=N,def=DEF,case=GEN,num=DU al-liqāʾayni
al-liqāʾi pos=N,def=INDF,case=NOM,num=DU liqāʾāni
al-lubnāniyyāni pos=ADJ,def=DEF,case=ACC,gen=FEM,num=DU al-lubnāniyyatayni
al-lubnāniyyāni pos=ADJ,def=DEF,case=NOM,gen=FEM,num=PL al-lubnāniyyāt
al-lubnāniyyayn pos=ADJ,def=DEF,case=GEN,gen=FEM,num=DU al-lubnāniyyatayni
al-luḡatayn pos=N,def=INDF,case=GEN,num=SG luḡatin
al-luḡatu pos=N,def=INDF,case=ACC,num=PL luḡātin
al-luḥuf pos=N,def=DEF,case=NOM,num=PL al-luḥufu
al-maʾāaḏinu pos=N,poss=PSSD,case=GEN,num=PL maʾāaḏini
al-maʿādin pos=N,def=DEF,case=NOM,num=DU al-maʿdinayn
al-maʿāhidi pos=N,def=INDF,case=ACC,num=SG maʿhadan
al-mabāliḡi pos=N,poss=PSSD,case=NOM,num=DU mablaḡā
al-mabdaʾayni pos=N,def=INDF,case=NOM,num=DU mabdaʾayn
al-mablūlata pos=ADJ,def=DEF,case=NOM,gen=MASC,num=SG al-mablūl
al-mablūlatayn pos=ADJ,def=INDF,case=NOM,gen=MASC,num=SG mablūlun
al-mabʿūṯāni pos=N,def=INDF,case=ACC,num=SG mabʿūṯan
al-mabʿūṯūna pos=N,poss=PSSD,case=NOM,num=PL mabʿūṯū
al-madaniyyatayni pos=ADJ,def=INDF,case=NOM,gen=FEM,num=PL madaniyyāt
al-madaniyyāti pos=ADJ,def=INDF,case=NOM,gen=FEM,num=SG madaniyyatun
al-madaniyyāt pos=ADJ,def=DEF,case=ACC,gen=MASC,num=DU al-madaniyyayni
al-madaniyyāt pos=ADJ,def=INDF,case=ACC,gen=FEM,num=DU madaniyyatayni
al-maḍbūṭi pos=ADJ,def=INDF,case=NOM,gen=MASC,num=DU maḍbūṭayn
al-maʿḏiratāni pos=N,poss=PSSD,case=NOM,num=DU maʿḏiratā
al-maʿḏiratayni pos=N,poss=PSSD,case=NOM,num=PL maʿāḏiru
al-madḵalāni pos=N,def=INDF,case=GEN,num=DU madḵalayni
al-madḵalayn pos=N,def=DEF,case=ACC,num=DU al-madḵalayni
al-mafqūdayni pos=ADJ,def=DEF,case=NOM,gen=FEM,num=PL al-mafqūdāt
al-mafqūd pos=ADJ,def=INDF,case=NOM,gen=FEM,num=DU mafqūdatāni
al-maḡāribiyyatayn pos=ADJ,def=INDF,case=GEN,gen=FEM,num=SG maḡāribiyyatin
al-maḡāribiyyāt pos=ADJ,def=DEF,case=GEN,gen=MASC,num=PL al-maḡāribiyyīna
al-maḡāribiyyūna pos=ADJ,def=DEF,case=NOM,gen=MASC,num=SG al-maḡāribī
al-maʿhadayn pos=N,def=DEF,case=GEN,num=DU al-maʿhadayni
al-maḥallāt pos=N,def=INDF,case=ACC,num=DU maḥallatayni
al-maḥallātu pos=N,def=DEF,case=GEN,num=PL al-maḥallāti
al-maḥārība pos=N,def=INDF,case=NOM,num=PL maḥārību
al-maḥārību pos=N,def=DEF,case=ACC,num=SG al-miḥrāba
al-maḥaṭṭata pos=N,def=INDF,case=NOM,num=DU maḥaṭṭatāni
al-maḥaṭṭatayn pos=N,def=INDF,case=ACC,num=PL maḥaṭṭātin
al-maḥaṭṭati pos=N,def=DEF,case=NOM,num=DU al-maḥaṭṭatāni
al-maḥbūbu pos=N,poss=PSSD,case=ACC,num=PL maḥābība
al-māʿizāni pos=N,def=INDF,case=ACC,num=PL mawāʿiza
al-māʿizi pos=N,def=DEF,case=ACC,num=PL al-mawāʿiza
al-majālāt pos=N,def=INDF,case=GEN,num=PL majālātin
al-majālu pos=N,def=DEF,case=NOM,num=PL al-majālātu
al-majāmīʿu pos=ADJ,def=INDF,case=NOM,gen=FEM,num=PL majmūʿāt
al-majhūlatu pos=ADJ,def=INDF,case=GEN,gen=MASC,num=PL majāhīla
al-majjāniyyatāni pos=ADJ,def=INDF,case=NOM,gen=MASC,num=SG majjānī
al-majjāniyyīn pos=ADJ,def=INDF,case=NOM,gen=FEM,num=DU majjāniyyatayn
al-majjāniyyūna pos=ADJ,def=DEF,case=ACC,gen=MASC,num=PL al-majjāniyyīna
al-majlisa pos=N,def=INDF,case=GEN,num=SG majlisin
al-majlisayn pos=N,def=INDF,case=GEN,num=PL majālisa
al-majlisi pos=N,def=INDF,case=ACC,num=SG majlisan
al-majlis pos=N,def=INDF,case=ACC,num=DU majlisayni
al-majlisu pos=N,poss=PSSD,case=ACC,num=SG majlisa
al-majmūʿatu pos=ADJ,def=DEF,case=GEN,gen=MASC,num=PL al-majāmīʿi
al-maḵābizu pos=N,def=INDF,case=NOM,num=PL maḵābiz
al-maḵādda pos=N,def=INDF,case=NOM,num=SG miḵaddatun
al-makāna pos=N,def=INDF,case=NOM,num=DU makānāni
al-makānayni pos=N,poss=PSSD,case=NOM,num=SG makān
al-makātībi pos=N,def=DEF,case=GEN,num=DU al-maktūbayni
al-makkiyyatayn pos=ADJ,def=INDF,case=NOM,gen=MASC,num=DU makkiyyāni
al-makkiyyūna pos=ADJ,def=INDF,case=ACC,gen=MASC,num=PL makkiyyīna
al-maksūru pos=ADJ,def=INDF,case=NOM,gen=FEM,num=SG maksūra
al-maktūbatayni pos=ADJ,def=INDF,case=NOM,gen=FEM,num=DU maktūbatāni
al-maḵtūnatayni pos=ADJ,def=DEF,case=NOM,gen=FEM,num=SG al-maḵtūnatu
al-maḵtūnātu pos=ADJ,def=DEF,case=NOM,gen=FEM,num=DU al-maḵtūnatayn
al-maḵtūnātu pos=ADJ,def=INDF,case=NOM,gen=FEM,num=DU maḵtūnatāni
al-maḵtūnayn pos=ADJ,def=INDF,case=NOM,gen=MASC,num=DU maḵtūnayn
al-maḵzani pos=N,def=INDF,case=NOM,num=SG maḵzan
al-maḵzani pos=N,poss=PSSD,case=NOM,num=SG maḵzan
al-malābisa pos=N,def=DEF,case=NOM,num=DU al-malbasayn
al-malāʾikiyyātu pos=ADJ,def=INDF,case=ACC,gen=MASC,num=DU malāʾikiyyayni
al-malāʾikiyyīna pos=ADJ,def=INDF,case=NOM,gen=MASC,num=PL malāʾikiyyīn
al-malāʾikiyyu pos=ADJ,def=DEF,case=NOM,gen=MASC,num=SG al-malāʾikī
al-malāʿiqa pos=N,def=DEF,case=NOM,num=PL al-malāʿiq
al-malbasu pos=N,def=INDF,case=GEN,num=DU malbasayni
al-malḥūnāti pos=ADJ,def=INDF,case=GEN,gen=FEM,num=PL malḥūnātin
al-malḥūnayn pos=ADJ,def=DEF,case=ACC,gen=MASC,num=DU al-malḥūnayni
al-maʿlūmātu pos=ADJ,def=INDF,case=ACC,gen=FEM,num=SG maʿlūmatan
al-maʿlūmi pos=ADJ,def=INDF,case=NOM,gen=FEM,num=PL maʿlūmāt
al-mamlūʾatayni pos=ADJ,def=INDF,case=NOM,gen=FEM,num=SG mamlūʾatun
al-mamlūʾayni pos=ADJ,def=INDF,case=ACC,gen=FEM,num=SG mamlūʾatan
al-mamlūʾayn pos=ADJ,def=INDF,case=GEN,gen=FEM,num=DU mamlūʾatayni
al-mamlūkayni pos=N,def=DEF,case=NOM,num=SG al-mamlūku
al-mamlūʾ pos=ADJ,def=INDF,case=ACC,gen=FEM,num=PL mamlūʾātin
al-mamnūʿi pos=ADJ,def=INDF,case=NOM,gen=FEM,num=SG mamnūʿa
al-mamnūʿu pos=ADJ,def=INDF,case=ACC,gen=FEM,num=DU mamnūʿatayni
al-manāhij pos=N,def=INDF,case=NOM,num=PL manāhiju
al-manāṭiqi pos=N,def=INDF,case=GEN,num=PL manāṭiqa
al-manāṭiqu pos=N,def=INDF,case=ACC,num=SG minṭaqatan
al-maqādīra pos=N,def=INDF,case=GEN,num=DU miqdārayni
al-maqālāti pos=N,def=INDF,case=GEN,num=DU maqālayni
al-maqāl pos=N,poss=PSSD,case=NOM,num=SG maqālu
al-maqarru pos=N,def=DEF,case=ACC,num=SG al-maqarra
al-maqāsayni pos=N,def=DEF,case=NOM,num=PL al-maqāsāt
al-maqfūla pos=ADJ,def=INDF,case=NOM,gen=FEM,num=PL maqfūlāt
al-maqṭūʿāt pos=ADJ,def=INDF,case=NOM,gen=FEM,num=DU maqṭūʿatāni
al-maqṭūʿ pos=ADJ,def=INDF,case=NOM,gen=MASC,num=SG maqṭūʿun
al-maʿqūlatāni pos=ADJ,def=INDF,case=NOM,gen=FEM,num=DU maʿqūlatāni
al-maʿqūl pos=ADJ,def=INDF,case=NOM,gen=MASC,num=DU maʿqūlayn
al-marāfiqi pos=N,def=INDF,case=GEN,num=SG mirfaqin
al-marāḥīḍa pos=N,def=DEF,case=NOM,num=SG al-mirḥāḍ
al-marāḥilu pos=N,def=DEF,case=ACC,num=DU al-marḥalatayni
al-marḥalati pos=N,def=DEF,case=GEN,num=PL al-marāḥili
al-māridatāni pos=ADJ,def=INDF,case=NOM,gen=FEM,num=SG māridatun
al-māridāt pos=ADJ,def=DEF,case=ACC,gen=MASC,num=DU al-māridayni
al-mārid pos=ADJ,def=INDF,case=NOM,gen=FEM,num=PL māridātun
al-maʿriḍu pos=N,poss=PSSD,case=NOM,num=PL maʿāriḍu
al-marra pos=N,poss=PSSD,case=ACC,num=PL marrāti
al-mārūniyyatayn pos=ADJ,def=INDF,case=NOM,gen=MASC,num=DU mārūniyyayn
al-mārūniyyīna pos=ADJ,def=INDF,case=NOM,gen=FEM,num=SG mārūniyyatun
al-marzūqāni pos=ADJ,def=INDF,case=NOM,gen=FEM,num=SG marzūqa
al-marzūqāti pos=ADJ,def=INDF,case=NOM,gen=MASC,num=DU marzūqāni
al-masāʾila pos=N,poss=PSSD,case=NOM,num=PL masāʾilu
al-masāʾili pos=N,def=INDF,case=NOM,num=DU masʾalatāni
al-masʾalatayni pos=N,poss=PSSD,case=ACC,num=DU masʾalatay
al-maṣāliḥ pos=N,poss=PSSD,case=NOM,num=DU maṣlaḥatay
al-masāmīri pos=N,def=INDF,case=GEN,num=PL masāmīra
al-masfūḥati pos=ADJ,def=INDF,case=NOM,gen=FEM,num=SG masfūḥatun
al-masfūḥātu pos=ADJ,def=DEF,case=NOM,gen=MASC,num=SG al-masfūḥu
al-masfūḥ pos=ADJ,def=DEF,case=NOM,gen=FEM,num=PL al-masfūḥāt
al-mašhūra pos=ADJ,def=INDF,case=NOM,gen=FEM,num=DU mašhūratayn
al-mašhūratayni pos=ADJ,def=DEF,case=ACC,gen=FEM,num=PL al-mašhūrāti
al-mašhūratayni pos=ADJ,def=INDF,case=ACC,gen=FEM,num=DU mašhūratayni
al-masīḥī pos=ADJ,def=INDF,case=ACC,gen=MASC,num=DU masīḥiyyayni
al-masīḥiyyatayn pos=ADJ,def=DEF,case=GEN,gen=MASC,num=PL al-masīḥiyyīna
al-masīḥiyyatayn pos=ADJ,def=INDF,case=NOM,gen=MASC,num=SG masīḥiyyun
al-masīḥiyyāt pos=ADJ,def=DEF,case=ACC,gen=MASC,num=SG al-masīḥiyya
al-masīḥiyyāt pos=ADJ,def=DEF,case=NOM,gen=MASC,num=DU al-masīḥiyyayn
al-masīḥiyyāt pos=ADJ,def=DEF,case=NOM,gen=MASC,num=PL al-masīḥiyyīn
al-maṣnaʿi pos=N,def=DEF,case=ACC,num=SG al-maṣnaʿa
al-mašrūʿāni pos=ADJ,def=DEF,case=ACC,gen=FEM,num=DU al-mašrūʿatayni
al-mašrūʿātu pos=ADJ,def=DEF,case=NOM,gen=MASC,num=DU al-mašrūʿāni
al-masʾūlatayni pos=ADJ,def=INDF,case=ACC,gen=MASC,num=SG masʾūlan
al-maṭābiḵa pos=N,def=DEF,case=NOM,num=PL al-maṭābiḵ
al-maṭāʿim pos=N,def=INDF,case=NOM,num=DU maṭʿamāni
al-maṯalayni pos=N,def=INDF,case=GEN,num=DU maṯalayni
al-maṭʿami pos=N,def=INDF,case=GEN,num=PL maṭāʿima
al-maṭbaḵayni pos=N,poss=PSSD,case=ACC,num=SG maṭbaḵa
al-matḥafi pos=N,def=DEF,case=NOM,num=DU al-matḥafāni
al-maṭlūbayni pos=N,def=INDF,case=GEN,num=SG maṭlūbin
al-mawāḍīʿu pos=N,poss=PSSD,case=GEN,num=PL mawāḍīʿi
al-mawāʿiz pos=N,def=INDF,case=ACC,num=PL mawāʿiza
al-mawḍūʿiyya pos=ADJ,def=INDF,case=NOM,gen=FEM,num=PL mawḍūʿiyyātun
al-mawḍūʿiyyu pos=ADJ,def=INDF,case=GEN,gen=MASC,num=SG mawḍūʿiyyin
al-mawsimāni pos=N,def=INDF,case=NOM,num=PL mawāsim
al-mawsūʿa pos=N,poss=PSSD,case=NOM,num=SG mawsūʿatu
al-mawsūʿati pos=N,def=DEF,case=ACC,num=PL al-mawsūʿāti
al-mawsūʿāti pos=N,def=DEF,case=GEN,num=DU al-mawsūʿatayni
al-maydānu pos=N,poss=PSSD,case=ACC,num=DU maydānay
al-miftāḥi pos=N,poss=PSSD,case=ACC,num=PL mafātīḥa
al-miḥnata pos=N,poss=PSSD,case=ACC,num=PL miḥana
al-miḥwara pos=N,def=INDF,case=GEN,num=SG miḥwarin
al-miḥwara pos=N,poss=PSSD,case=NOM,num=DU miḥwarā
al-miḥwarayn pos=N,def=INDF,case=NOM,num=DU miḥwarayn
al-mikrūbayni pos=N,def=DEF,case=GEN,num=PL al-mikrūbāti
al-mikrūbu pos=N,def=INDF,case=NOM,num=SG mikrūbun
al-mīlādayni pos=N,def=INDF,case=NOM,num=PL mawālīd
al-milʿaqatāni pos=N,def=DEF,case=NOM,num=PL al-malāʿiq
al-milʿaqati pos=N,poss=PSSD,case=NOM,num=SG milʿaqatu
al-minšafatāni pos=N,def=DEF,case=NOM,num=PL al-manāšifu
al-minšafatayni pos=N,poss=PSSD,case=GEN,num=SG minšafati
al-minšafatayn pos=N,def=DEF,case=NOM,num=SG al-minšafatu
al-minṭaqa pos=N,def=DEF,case=GEN,num=DU al-minṭaqatayni
al-minṭaqa pos=N,poss=PSSD,case=NOM,num=DU minṭaqatā
al-minṭaqatayni pos=N,def=INDF,case=GEN,num=SG minṭaqatin
al-miqdārayn pos=N,def=INDF,case=NOM,num=PL maqādīru
al-miṣʿad pos=N,def=DEF,case=NOM,num=DU al-miṣʿadāni
al-miskīnāni pos=ADJ,def=INDF,case=GEN,gen=FEM,num=DU miskīnatayni
al-miskīnata pos=ADJ,def=DEF,case=NOM,gen=MASC,num=PL al-masākīnu
al-miskīnātu pos=ADJ,def=INDF,case=ACC,gen=MASC,num=DU miskīnayni
al-miṣriyyāt pos=ADJ,def=DEF,case=ACC,gen=FEM,num=SG al-miṣriyyata
al-miṣriyyayni pos=ADJ,def=INDF,case=GEN,gen=MASC,num=DU miṣriyyayni
al-miṯāla pos=N,def=INDF,case=NOM,num=DU miṯālayn
al-miṯāli pos=N,def=INDF,case=GEN,num=SG miṯālin
al-miṯlayn pos=N,poss=PSSD,case=NOM,num=PL ʾamṯāl
al-miṯliyyatayn pos=ADJ,def=DEF,case=GEN,gen=MASC,num=PL al-miṯliyyīna
al-miṯliyyīn pos=ADJ,def=DEF,case=ACC,gen=MASC,num=DU al-miṯliyyayni
al-miṯl pos=N,def=INDF,case=NOM,num=DU miṯlāni
al-miṯqāli pos=N,def=INDF,case=NOM,num=PL maṯāqīlu
al-miṯqāl pos=N,poss=PSSD,case=NOM,num=PL maṯāqīlu
al-miṯqālu pos=N,def=INDF,case=GEN,num=SG miṯqālin
al-miṭraqati pos=N,def=INDF,case=ACC,num=PL maṭāriqa
al-mīzānāni pos=N,poss=PSSD,case=GEN,num=DU mīzānay
al-mīzāni pos=N,def=INDF,case=NOM,num=SG mīzānun
al-mizmārāni pos=N,poss=PSSD,case=GEN,num=SG mizmāri
al-mizmārayni pos=N,def=INDF,case=GEN,num=DU mizmārayni
al-muʾaḏḏinīn pos=N,poss=PSSD,case=GEN,num=SG muʾaḏḏini
al-muʾaḏḏinu pos=N,def=DEF,case=NOM,num=DU al-muʾaḏḏinayn
al-muʾallifūna pos=N,def=INDF,case=NOM,num=DU muʾallifayn
al-muʿaqqada pos=ADJ,def=DEF,case=NOM,gen=MASC,num=SG al-muʿaqqad
al-muʿaqqadatayn pos=ADJ,def=DEF,case=ACC,gen=FEM,num=DU al-muʿaqqadatayni
al-muʿaqqadatayn pos=ADJ,def=INDF,case=NOM,gen=FEM,num=PL muʿaqqadāt
al-muʿaqqadati pos=ADJ,def=DEF,case=NOM,gen=MASC,num=PL al-muʿaqqadīn
al-muʿaqqadati pos=ADJ,def=DEF,case=NOM,gen=FEM,num=DU al-muʿaqqadatāni
al-muʿaqqadūna pos=ADJ,def=DEF,case=GEN,gen=FEM,num=SG al-muʿaqqadati
al-muʾaqqatatayni pos=ADJ,def=INDF,case=GEN,gen=MASC,num=SG muʾaqqatin
al-muʾaqqatati pos=ADJ,def=INDF,case=ACC,gen=MASC,num=PL muʾaqqatīna
al-muʾaqqatu pos=ADJ,def=INDF,case=NOM,gen=MASC,num=DU muʾaqqatāni
al-muʾarriḵayni pos=N,def=INDF,case=GEN,num=PL muʾarriḵīna
al-muʾarriḵīna pos=N,def=DEF,case=GEN,num=DU al-muʾarriḵayni
al-muʿarriqata pos=ADJ,def=INDF,case=GEN,gen=MASC,num=DU muʿarriqayni
al-muʿarriqati pos=ADJ,def=DEF,case=GEN,gen=MASC,num=SG al-muʿarriqi
al-muʿāṣira pos=ADJ,def=INDF,case=GEN,gen=FEM,num=SG muʿāṣiratin
al-muʿāṣirata pos=ADJ,def=DEF,case=ACC,gen=FEM,num=DU al-muʿāṣiratayni
al-muʿāṣirayni pos=ADJ,def=DEF,case=NOM,gen=FEM,num=SG al-muʿāṣira
al-muʿāṣirayni pos=ADJ,def=INDF,case=GEN,gen=MASC,num=SG muʿāṣirin
al-mubayyiḍayn pos=N,def=INDF,case=NOM,num=SG mubayyiḍun
al-mubayyiḍ pos=N,def=DEF,case=ACC,num=PL al-mubayyiḍīna
al-mubayyiḍūna pos=N,poss=PSSD,case=NOM,num=PL mubayyiḍū
al-mubtadaʾayni pos=N,def=INDF,case=NOM,num=PL mubtadaʾīn
al-mubtadaʾi pos=N,poss=PSSD,case=NOM,num=DU mubtadaʾā
al-mubtadiʾūna pos=N,def=DEF,case=GEN,num=SG al-mubtadiʾi
al-muḏākarati pos=N,def=DEF,case=ACC,num=PL al-muḏākarāti
al-muḍāriʿa pos=ADJ,def=DEF,case=NOM,gen=FEM,num=DU al-muḍāriʿatayn
al-muḍāriʿi pos=ADJ,def=DEF,case=NOM,gen=MASC,num=DU al-muḍāriʿayn
al-mudawwanata pos=N,def=DEF,case=NOM,num=SG al-mudawwanatu
al-mudawwanati pos=N,poss=PSSD,case=NOM,num=SG mudawwanat
al-mudawwanatu pos=N,poss=PSSD,case=NOM,num=DU mudawwanatay
al-mudawwaratāni pos=ADJ,def=INDF,case=NOM,gen=MASC,num=DU mudawwarayn
al-mudawwarata pos=ADJ,def=DEF,case=NOM,gen=FEM,num=PL al-mudawwarātu
al-mudawwarata pos=ADJ,def=INDF,case=GEN,gen=FEM,num=DU mudawwaratayni
al-muddati pos=N,def=DEF,case=ACC,num=DU al-muddatayni
al-mudhišayn pos=ADJ,def=INDF,case=GEN,gen=FEM,num=SG mudhišatin
al-muḍirru pos=ADJ,def=INDF,case=NOM,gen=FEM,num=PL muḍirrāt
al-mufājaʾata pos=N,def=INDF,case=NOM,num=SG mufājaʾatun
al-mufattiša pos=N,def=DEF,case=ACC,num=DU al-mufattišayni
al-mufīdatayn pos=ADJ,def=DEF,case=GEN,gen=MASC,num=SG al-mufīdi
al-mufīdāti pos=ADJ,def=DEF,case=ACC,gen=FEM,num=DU al-mufīdatayni
al-mufīdayn pos=ADJ,def=DEF,case=ACC,gen=MASC,num=DU al-mufīdayni
al-mufīdayn pos=ADJ,def=INDF,case=GEN,gen=MASC,num=SG mufīdin
al-muḥāfiẓātu pos=ADJ,def=INDF,case=GEN,gen=FEM,num=PL muḥāfiẓātin
al-muḥāfiẓi pos=ADJ,def=DEF,case=GEN,gen=FEM,num=SG al-muḥāfiẓati
al-muhājima pos=ADJ,def=INDF,case=NOM,gen=MASC,num=DU muhājimāni
al-muhājimāt pos=ADJ,def=DEF,case=NOM,gen=FEM,num=DU al-muhājimatayn
al-muhājimatu pos=ADJ,def=DEF,case=ACC,gen=FEM,num=DU al-muhājimatayni
al-muhājirāni pos=N,def=DEF,case=NOM,num=PL al-muhājirīn
al-muḥammada pos=ADJ,def=DEF,case=ACC,gen=FEM,num=PL al-muḥammadāti
al-muḥammadatāni pos=ADJ,def=DEF,case=NOM,gen=MASC,num=SG al-muḥammad
al-muḥammadata pos=ADJ,def=DEF,case=ACC,gen=MASC,num=DU al-muḥammadayni
al-muḥammadatu pos=ADJ,def=DEF,case=ACC,gen=MASC,num=DU al-muḥammadayni
al-muhandisatayn pos=ADJ,def=INDF,case=ACC,gen=FEM,num=SG muhandisatan
al-muhandisi pos=ADJ,def=DEF,case=GEN,gen=FEM,num=SG al-muhandisati
al-muhandis pos=ADJ,def=INDF,case=NOM,gen=MASC,num=PL muhandisūna
al-muḥāriba pos=N,def=DEF,case=NOM,num=PL al-muḥāribūna
al-muḥarramāni pos=ADJ,def=INDF,case=GEN,gen=FEM,num=DU muḥarramatayni
al-muḥarramātu pos=ADJ,def=DEF,case=GEN,gen=MASC,num=PL al-muḥarramīna
al-muḥarramu pos=ADJ,def=INDF,case=NOM,gen=MASC,num=SG muḥarramun
al-muḥarrika pos=N,def=DEF,case=NOM,num=PL al-muḥarrikātu
al-muḥarrikāti pos=N,poss=PSSD,case=NOM,num=DU muḥarrikā
al-muḥassinu pos=N,def=INDF,case=NOM,num=PL muḥassinātun
al-muḥāwalatayni pos=N,def=INDF,case=GEN,num=DU muḥāwalatayni
al-muḥibbayn pos=N,poss=PSSD,case=NOM,num=DU muḥibbay
al-muḥibbīn pos=N,poss=PSSD,case=ACC,num=DU muḥibbay
al-muḥibbūna pos=N,def=DEF,case=NOM,num=DU al-muḥibbayn
al-muhimmatu pos=ADJ,def=INDF,case=GEN,gen=MASC,num=DU muhimmayni
al-muhimmayni pos=ADJ,def=DEF,case=GEN,gen=MASC,num=SG al-muhimmi
al-muḥīṭata pos=ADJ,def=INDF,case=ACC,gen=MASC,num=SG muḥīṭan
al-muḥīṭ pos=N,poss=PSSD,case=ACC,num=PL muḥīṭāti
al-muḥsinatāni pos=ADJ,def=DEF,case=NOM,gen=FEM,num=PL al-muḥsinātu
al-muḥsinati pos=ADJ,def=DEF,case=NOM,gen=MASC,num=DU al-muḥsināni
al-muḥsinatu pos=ADJ,def=DEF,case=ACC,gen=FEM,num=DU al-muḥsinatayni
al-muḥtalimatayni pos=ADJ,def=DEF,case=NOM,gen=MASC,num=DU al-muḥtalimayn
al-muḥtalimati pos=ADJ,def=DEF,case=GEN,gen=MASC,num=DU al-muḥtalimayni
al-muḥtamalatayn pos=ADJ,def=INDF,case=GEN,gen=MASC,num=SG muḥtamalin
al-muḥtamalati pos=ADJ,def=DEF,case=NOM,gen=FEM,num=SG al-muḥtamalatu
al-muḥtamal pos=ADJ,def=INDF,case=ACC,gen=FEM,num=PL muḥtamalātin
al-mujaffilayni pos=ADJ,def=INDF,case=NOM,gen=FEM,num=DU mujaffilatāni
al-mujaffilayn pos=ADJ,def=INDF,case=ACC,gen=MASC,num=DU mujaffilayni
al-mujāhidu pos=N,poss=PSSD,case=NOM,num=PL mujāhidū
al-mujtamaʿayni pos=N,poss=PSSD,case=NOM,num=PL mujtamaʿāt
al-mujtamaʿu pos=N,def=DEF,case=NOM,num=DU al-mujtamaʿayn
al-mukāfaʾatayni pos=N,def=DEF,case=NOM,num=PL al-mukāfaʾāt
al-muḵannaṯ pos=ADJ,def=DEF,case=GEN,gen=FEM,num=SG al-muḵannaṯati
al-mumarriḍayn pos=N,poss=PSSD,case=NOM,num=SG mumarriḍu
al-mumarriḍūna pos=N,poss=PSSD,case=ACC,num=SG mumarriḍa
al-mumilla pos=ADJ,def=DEF,case=NOM,gen=MASC,num=SG al-mumillu
al-mumillati pos=ADJ,def=DEF,case=ACC,gen=FEM,num=DU al-mumillatayni
al-mumillīn pos=ADJ,def=INDF,case=NOM,gen=FEM,num=DU mumillatayn
al-mumtaliʾ pos=ADJ,def=DEF,case=NOM,gen=FEM,num=SG al-mumtaliʾa
al-mumtaliʾu pos=ADJ,def=DEF,case=NOM,gen=MASC,num=SG al-mumtaliʾ
al-mumtāzatayn pos=ADJ,def=INDF,case=NOM,gen=MASC,num=DU mumtāzāni
al-munāfasatayn pos=N,poss=PSSD,case=NOM,num=DU munāfasatā
al-munāsibatāni pos=ADJ,def=INDF,case=NOM,gen=MASC,num=SG munāsibun
al-munāsibata pos=ADJ,def=INDF,case=NOM,gen=FEM,num=DU munāsibatāni
al-munāsibatayni pos=ADJ,def=DEF,case=GEN,gen=FEM,num=PL al-munāsibāti
al-munāsibu pos=ADJ,def=INDF,case=ACC,gen=FEM,num=PL munāsibātin
al-munawwimāti pos=ADJ,def=DEF,case=NOM,gen=FEM,num=PL al-munawwimātu
al-mundaṯiratayn pos=ADJ,def=INDF,case=NOM,gen=MASC,num=DU mundaṯirāni
al-mundaṯirīn pos=ADJ,def=INDF,case=GEN,gen=MASC,num=DU mundaṯirayni
al-munfaṣili pos=ADJ,def=DEF,case=NOM,gen=MASC,num=PL al-munfaṣilūna
al-munḵafaḍa pos=N,poss=PSSD,case=NOM,num=SG munḵafaḍ
